/50	50	50s	
/aah	aah	aahing	
/ab	ab	abs	
/abandon	abandon	abandoned	abandoning	
/abil	abilities	ability	
/abomin	abomination	abominations	
/absolut	absolute	absolutely	
/absorb	absorb	absorbed	absorbent	absorbing	absorbs	
/abus	abuse	abused	abusing	
/acceler	accelerated	accelerating	acceleration	
/accent	accent	accented	accents	
/accept	accept	acceptable	acceptance	accepted	accepting	accepts	
/access	access	accessible	
/accessori	accessories	accessory	
/accid	accident	accidents	
/accident	accidental	accidentally	
/accompani	accompaniment	accompany	accompanying	
/accomplish	accomplish	accomplished	accomplishing	accomplishment	accomplishments	
/accord	accord	according	
/account	account	accounted	accounts	
/accredit	accredit	accreditation	accredited	
/accus	accusation	accusations	accuse	accused	accusing	
/ace	ace	aces	
/ach	ache	aches	aching	
/achiev	achieve	achieved	achievement	achieving	
/acknowledg	acknowledge	acknowledges	
/acorn	acorn	acorns	
/acoust	acoustic	acoustics	
/acquaint	acquaintance	acquaintances	
/acr	acre	acres	
/acrobat	acrobat	acrobatic	acrobatics	
/act	act	acted	acting	acts	
/action	action	actions	
/activ	activate	activated	activates	activating	active	activities	activity	
/actor	actor	actors	
/actress	actress	actresses	
/actual	actual	actually	
/acuda	acuda	acudas	
/ad	added	adding	
/adapt	adapt	adapting	
/add	add	adds	
/addit	addition	additional	additions	
/address	address	addressed	addressing	
/adequ	adequate	adequately	
/adher	adhere	adherence	
/adjourn	adjourn	adjourned	
/adjust	adjust	adjusting	adjustment	adjustments	
/admir	admirable	admiral	admiration	admire	admired	admirer	admirers	admiring	
/admit	admit	admitted	admitting	
/adopt	adopt	adopting	adoption	
/ador	adorable	adorably	adoration	adore	adored	adores	adoring	
/advanc	advance	advanced	advancing	
/advantag	advantage	advantages	
/adventur	adventure	adventurer	adventurers	adventures	adventuring	adventurous	
/advers	adversities	adversity	
/advertis	advertised	advertisement	advertising	
/advis	advise	advisement	adviser	
/aesthet	aesthetically	aesthetics	
/affair	affair	affairs	
/affect	affect	affected	affecting	affects	
/affirm	affirmations	affirmative	affirmatives	affirming	
/afterward	afterward	afterwards	
/age	age	aged	ages	aging	
/aggress	aggression	aggressive	
/agil	agile	agility	
/agre	agree	agreed	agreeing	agrees	
/agreement	agreement	agreements	
/ah	ah	ahhing	
/ahh	ahh	ahhs	
/aid	aid	aids	
/ail	ail	ailing	ails	
/ailment	ailment	ailments	
/aim	aim	aiming	
/air	air	airing	
/airship	airship	airships	
/airsick	airsick	airsickness	
/alert	alert	alerted	alerts	
/alicorn	alicorn	alicorns	
/align	align	aligned	
/all	all	alls	
/alley	alley	alleys	
/alli	allies	ally	
/allig	alligator	alligators	
/allow	allow	allowed	allowing	allows	
/alter	alter	alterations	altered	
/altern	alternate	alternating	alternative	
/amaz	amaze	amazed	amazement	amazing	
/amend	amending	amends	
/amethyst	amethyst	amethysts	
/amigo	amigo	amigos	
/amount	amount	amounts	
/amplifi	amplified	amplify	
/amulet	amulet	amulets	
/amus	amused	amusement	amusing	
/anecdot	anecdote	anecdotes	
/angel	angel	angelic	angels	
/angl	angle	angles	angling	
/anim	animal	animals	animate	animated	
/ankl	ankle	ankles	
/announc	announce	announced	announcement	announcements	announcer	announcers	announces	announcing	
/annoy	annoyed	annoying	
/answer	answer	answered	answering	answers	
/anticip	anticipated	anticipation	
/antiqu	antique	antiquing	antiquities	
/antler	antler	antlers	
/anyway	anyway	anyways	
/apart	apart	apartment	
/apolog	apologies	apologize	apologized	apologizing	apology	
/app	app	apps	
/apparit	apparition	apparitions	
/appear	appear	appearance	appearances	appeared	appears	
/appet	appetizer	appetizers	
/appl	apple	apples	
/applaud	applaud	applauding	applauds	
/applebuck	applebuck	applebucking	
/applejack	applejack	applejacks	
/appleloosan	appleloosan	appleloosans	
/appli	applied	applies	apply	
/applic	applicable	applicants	application	applications	
/appliquã©	appliquã©	appliquã©s	
/appoint	appoint	appointment	appointments	
/appreci	appreciate	appreciated	appreciates	appreciating	appreciation	appreciative	
/approach	approach	approached	approaches	approaching	
/appropri	appropriate	appropriation	
/approv	approval	approve	approved	approving	
/apricot	apricot	apricots	
/apron	apron	aprons	
/archer	archer	archers	
/architectur	architectural	architecture	
/area	area	areas	
/argu	argue	argued	arguing	
/argument	argument	arguments	
/ari	ari	aris	
/aria	aria	arias	
/arm	arm	arms	
/armi	armies	army	
/arrang	arrange	arranged	arrangement	arrangements	arranging	
/arrest	arrest	arrests	
/arriv	arrival	arrive	arrived	arrives	arriving	
/arrow	arrow	arrows	
/art	art	arte	arts	
/articl	article	articles	
/artifact	artifact	artifacts	
/artist	artist	artiste	artistes	artistic	artists	
/ascend	ascend	ascending	
/ash	ash	ashes	
/ask	ask	asked	asking	asks	
/assembl	assemble	assembled	assembly	
/assent	assent	assenting	
/assert	assert	asserting	assertion	assertive	assertiveness	
/assign	assigned	assigning	assignment	assignments	
/assist	assist	assistance	assistant	assistants	assisted	assisting	assists	
/associ	associate	associating	association	
/assort	assorted	assortment	
/assum	assume	assumed	assuming	
/assur	assurance	assure	assured	
/astonish	astonished	astonishing	
/astound	astound	astounding	
/astronom	astronomer	astronomical	astronomically	
/athlet	athlete	athletes	athletic	athletics	
/attach	attach	attached	
/attack	attack	attacked	attacking	attacks	
/attempt	attempt	attempted	attempting	attempts	
/attend	attend	attendance	attended	attending	
/attent	attention	attentive	
/attitud	attitude	attitudes	
/attract	attracted	attracting	attraction	attractive	attracts	
/audienc	audience	audiences	
/audit	audition	auditions	
/aunt	aunt	aunts	
/authent	authentic	authenticity	
/author	author	authority	authorized	
/autobiographi	autobiographies	autobiography	
/autograph	autograph	autographs	
/avalanch	avalanche	avalanches	
/avoid	avoid	avoided	avoiding	
/aw	aw	awful	awfully	
/await	await	awaiting	awaits	
/awar	aware	awareness	
/award	award	awards	
/awe	awe	awed	awing	
/awesom	awesome	awesomely	awesomeness	awesomer	
/awww	awww	awwws	
/babbl	babbles	babbling	
/babi	babies	baby	babying	
/babysit	babysit	babysitting	
/back	back	backed	backing	backs	
/backfir	backfire	backfired	backfires	backfiring	
/backward	backward	backwards	
/bad	bad	badness	bads	
/baddi	baddie	baddies	
/badg	badge	badges	
/badger	badger	badgers	
/bag	bag	bags	
/bail	bail	bailing	
/bake	bake	baked	bakes	baking	
/baker	baker	bakers	
/bald	bald	baldness	
/bale	bale	bales	
/ball	ball	balling	balls	
/balloon	balloon	balloons	
/ballot	ballot	ballots	
/bamboozl	bamboozle	bamboozlers	
/ban	ban	banned	bans	
/banana	banana	bananas	
/band	band	banded	bands	
/bang	bang	banged	banging	bangs	
/banish	banish	banished	banishes	banishing	banishment	
/bank	bank	banking	
/banner	banner	banners	
/bar	bar	barred	bars	
/bare	bare	barely	
/barf	barf	barfs	
/barg	barge	barging	
/bargain	bargain	bargains	
/bark	bark	barking	barks	
/barrel	barrel	barreling	barrels	
/base	base	based	bases	
/basic	basic	basically	basics	
/bask	bask	basked	basking	
/basket	basket	baskets	
/bat	bat	bats	
/batch	batch	batches	
/bath	bath	bathe	bathed	baths	
/battl	battle	battled	battles	battling	
/baubl	bauble	baubles	
/bawl	bawling	bawls	
/be	be	being	beings	
/beach	beach	beaches	
/bead	beading	beads	
/beak	beak	beaks	
/beam	beam	beams	
/bean	bean	beans	
/bear	bear	bears	
/beard	beard	bearded	
/beast	beast	beasts	
/beat	beat	beating	beats	
/beauti	beauties	beautiful	beautifully	beauty	
/beautifi	beautify	beautifying	
/beaver	beaver	beavers	
/becom	become	becomes	becoming	
/bed	bed	beds	
/bedazzl	bedazzled	bedazzling	
/bedrol	bedroll	bedrolls	
/bee	bee	bees	
/beep	beep	beeping	beeps	
/beetl	beetle	beetles	
/befriend	befriend	befriending	
/beg	beg	begged	begging	
/begin	begin	beginning	begins	
/beginn	beginner	beginners	
/behav	behave	behaved	behaves	behaving	
/belch	belch	belches	belching	
/believ	believable	believe	believed	believer	believes	believing	
/bell	bell	belle	belles	bells	
/bellow	bellowing	bellows	
/belong	belong	belonged	belongs	
/belt	belt	belted	belts	
/bend	bend	bending	
/benefit	benefit	benefited	benefits	
/berri	berries	berry	
/besid	beside	besides	
/besmirch	besmirch	besmirching	
/best	best	bested	
/bet	bet	bets	betting	
/betray	betray	betrayal	betrayed	
/betti	betty	bettys	
/beverag	beverage	beverages	
/bff	bff	bffs	
/bicker	bicker	bickering	
/bid	bid	bidding	
/bide	bidee	biding	
/big	big	bigness	
/bike	bike	bikes	
/bill	bill	billed	
/biolog	biological	biology	
/bird	bird	birds	
/birdi	birdie	birdies	birdy	
/birthday	birthday	birthdays	
/biscuit	biscuit	biscuits	
/bit	bit	bits	
/bite	bite	bites	biting	
/bitter	bitter	bitterness	
/black	black	blackness	
/blackberri	blackberries	blackberry	
/blame	blame	blamed	blames	blaming	
/blanket	blanket	blankets	
/blanki	blankie	blanky	
/blare	blare	blares	blaring	
/blast	blast	blasted	blasts	
/blaze	blaze	blazes	blazing	
/ble	ble	bles	
/bleat	bleat	bleating	bleats	
/blend	blend	blended	blending	blends	
/bless	bless	blessed	blessing	blessings	
/blight	blight	blighted	
/blind	blind	blinded	blinds	
/blindfold	blindfold	blindfolded	blindfolds	
/blink	blink	blinking	blinks	
/bliss	bliss	blissed	
/block	block	blocked	blocking	blocks	
/bloom	bloom	blooming	blooms	
/blossom	blossom	blossomed	
/blow	blow	blowing	blows	
/blue	blue	blues	
/blueberri	blueberries	blueberry	
/blueprint	blueprint	blueprints	
/blunt	blunt	bluntness	
/blush	blush	blushed	
/bo	bo	boing	
/board	board	boarded	boards	
/boast	boast	boasting	
/boat	boat	boats	
/bob	bob	bobbing	
/bobbin	bobbin	bobbins	
/bodi	bodies	body	
/boil	boil	boiling	boils	
/bolt	bolt	bolts	
/bomb	bomb	bombs	
/bond	bond	bonding	bonds	
/bone	bone	boned	bones	
/bongo	bongo	bongos	
/bonk	bonk	bonking	bonks	
/bonnet	bonnet	bonnets	
/boo	boo	booing	
/book	book	booked	books	
/boom	boom	booming	
/boost	boost	boosts	
/boot	boot	booted	boots	
/border	border	bordering	borders	
/bore	bore	bored	boring	
/borrow	borrow	borrowed	borrower	borrowing	
/bother	bother	bothered	bothering	bothers	
/bottl	bottle	bottled	bottles	
/bottom	bottom	bottomed	bottoms	
/boulder	boulder	boulders	
/bounc	bounce	bounces	bouncing	
/bound	bound	bounds	
/boundari	boundaries	boundary	
/bounti	bounties	bountiful	bounty	
/boutiqu	boutique	boutiques	
/bow	bow	bowing	bows	
/bowl	bowl	bowling	
/box	box	boxes	
/boy	boy	boys	
/brace	brace	braces	
/bracelet	bracelet	bracelets	
/brag	brag	bragging	
/braid	braid	braiding	braids	
/brain	brain	brains	
/brainwash	brainwash	brainwashed	
/brake	brake	brakes	braking	
/branch	branch	branches	
/brave	brave	bravely	
/brawn	brawn	brawns	
/bray	bray	braying	brays	
/breach	breached	breaches	
/break	break	breaking	breaks	
/breakabl	breakable	breakables	
/breaker	breaker	breakers	
/breakfast	breakfast	breakfasts	
/breakout	breakout	breakouts	
/breath	breath	breathe	breathed	breathes	breathing	breaths	
/breed	breed	breeding	breeds	
/breezi	breezie	breezies	breezy	
/brew	brew	brewing	brews	
/bride	bride	brides	
/bridg	bridge	bridges	
/brief	brief	briefed	briefing	briefings	
/bright	bright	brightness	
/brighten	brighten	brightening	brightens	
/bring	bring	bringing	brings	
/bro	bro	bros	
/brooch	brooch	brooches	
/broom	broom	brooms	
/brother	brother	brothers	
/brush	brush	brushes	brushing	
/brussel	brussel	brussels	
/brute	brute	brutes	
/bsff	bsff	bsffs	
/bu	bu	bus	
/bubbl	bubble	bubbles	bubbling	bubbly	
/buck	buck	bucked	bucking	bucks	
/bucket	bucket	buckets	
/bud	bud	buds	
/buddi	buddies	buddy	
/budget	budget	budgeted	
/buffet	buffet	buffets	
/buffi	buffied	buffy	
/bug	bug	bugs	
/bugbear	bugbear	bugbears	
/build	build	building	buildings	builds	
/bulli	bullied	bullies	bully	
/bum	bum	bumming	
/bump	bump	bumped	bumping	bumps	
/bumper	bumper	bumpers	
/bunk	bunk	bunks	
/bunni	bunnies	bunny	
/burbl	burbles	burbling	
/buri	buried	bury	
/burn	burn	burned	burning	burns	
/burp	burp	burped	burping	burps	
/burst	burst	bursting	bursts	
/bush	bush	bushes	
/bushel	bushel	bushels	
/busi	business	busy	
/bust	bust	busted	busting	
/buster	buster	busters	
/bustl	bustle	bustled	bustles	bustling	
/but	but	buts	
/butter	butter	buttering	
/butterfli	butterflies	butterfly	
/button	button	buttons	
/buy	buy	buying	buys	
/buzz	buzz	buzzed	buzzes	buzzing	
/buzzard	buzzard	buzzards	
/bwanki	bwankie	bwanky	
/bygon	bygone	bygones	
/bylaw	bylaw	bylaws	
/cackl	cackles	cackling	
/cadet	cadet	cadets	
/cage	cage	caged	cages	
/cake	cake	caked	cakes	
/calcul	calculation	calculations	
/call	call	called	calling	calls	
/calm	calm	calmed	calming	calms	
/camera	camera	cameras	
/camp	camp	camped	camping	camps	
/camper	camper	campers	
/can	can	canned	cans	
/cancel	cancel	canceled	canceling	cancellations	cancelled	cancelling	cancels	
/candi	candied	candies	candy	
/candid	candid	candidate	candidates	candids	
/candl	candle	candles	
/cane	cane	canes	
/cannon	cannon	cannons	
/cano	cano	canoe	canoeing	canoes	
/canter	canter	cantering	
/cap	cap	caps	
/capabl	capabilities	capable	
/cape	cape	capes	
/capsiz	capsize	capsized	capsizing	
/captain	captain	captains	
/captiv	captivate	captivating	captive	
/captur	capture	captured	capturing	
/car	car	cars	
/caravan	caravan	caravans	
/card	card	cards	
/care	care	cared	careful	carefully	cares	caring	
/careless	careless	carelessness	
/carol	carol	carolers	carols	
/carpet	carpet	carpeters	
/carri	carried	carries	carry	carrying	
/carriag	carriage	carriages	
/carrot	carrot	carrots	
/cart	cart	carts	
/case	case	cases	
/cast	cast	casting	
/castl	castle	castles	
/cat	cat	cats	
/catch	catch	catches	catching	
/catcher	catcher	catchers	
/catchphras	catchphrase	catchphrases	
/categor	categorical	categorically	categorize	
/categori	categories	category	
/cater	catered	caterer	catering	
/cattail	cattail	cattails	
/caus	cause	caused	causes	causing	
/caution	caution	cautioned	
/cave	cave	caves	
/cavern	cavern	cavernous	caverns	
/caw	cawing	caws	
/ceas	cease	ceased	
/ceil	ceiling	ceilings	
/celebr	celebrate	celebrated	celebrates	celebrating	celebration	celebrations	celebrities	celebrity	
/cell	cell	cells	
/centaur	centaur	centaurs	
/center	center	centered	
/centerpiec	centerpiece	centerpieces	
/centuri	centuries	century	
/ceremoni	ceremonial	ceremonies	ceremony	
/certif	certificate	certificates	
/certifi	certifiably	certified	
/ch	ch	chs	
/chafe	chafe	chafing	
/chain	chain	chained	chains	
/chair	chair	chairs	
/challeng	challenge	challenged	challenges	challenging	
/champ	champ	champs	
/champion	champion	champions	
/chanc	chance	chances	
/chancellor	chancellor	chancellorness	
/chandeli	chandelier	chandeliers	
/chang	change	changed	changes	changing	
/changel	changeling	changelings	
/channel	channel	channeling	
/chant	chant	chanted	chanting	chants	
/chaperon	chaperone	chaperones	
/chapter	chapter	chapters	
/charact	character	characters	
/charad	charade	charades	
/charg	charge	charged	charges	charging	
/chariti	charities	charity	
/charlatan	charlatan	charlatans	
/charm	charm	charmed	charming	charms	
/chart	chart	charted	charts	
/chase	chase	chased	chasing	
/chat	chat	chatting	
/chatter	chatter	chattering	chatters	
/cheat	cheat	cheated	cheating	
/cheater	cheater	cheaters	
/check	check	checked	checking	checks	
/checklist	checklist	checklists	
/cheek	cheek	cheeks	
/cheer	cheer	cheered	cheerful	cheering	cheers	
/cheerlead	cheerleaders	cheerleading	
/chef	chef	chefs	
/cherri	cherries	cherry	
/chew	chew	chewed	chewing	chews	
/chick	chick	chicks	
/chicken	chicken	chickens	
/chill	chill	chilling	chills	
/chillax	chillax	chillaxing	
/chime	chime	chimes	chiming	
/chimera	chimera	chimerae	
/chip	chip	chipped	chipping	chips	
/chipmunk	chipmunk	chipmunks	
/chirp	chirp	chirping	chirps	
/chitchat	chitchat	chitchatting	
/chitter	chitter	chittering	chitters	
/choic	choice	choices	
/choke	choke	choked	chokes	choking	
/chomp	chomp	chomping	chomps	
/choos	choose	chooses	choosing	
/chop	chop	chopped	chopping	chops	
/chord	chord	chords	
/chore	chore	chores	
/choreograph	choreograph	choreographer	choreographing	
/chow	chow	chowing	
/chronicl	chronicle	chronicles	
/chronolog	chronological	chronologically	
/chuckl	chuckle	chuckled	chuckles	chuckling	
/chum	chum	chums	
/chump	chump	chumps	
/chunk	chunk	chunks	
/circl	circle	circles	circling	
/circuit	circuit	circuits	
/circumst	circumstance	circumstances	
/citi	cities	city	
/citizen	citizen	citizens	
/clack	clack	clacking	
/claim	claim	claimed	claiming	claims	
/clang	clang	clanging	clangs	
/clank	clank	clanking	clanks	
/clap	clap	clapping	claps	
/clash	clash	clashed	clashes	
/class	class	classes	
/classic	classic	classical	classics	
/classmat	classmate	classmates	
/classroom	classroom	classrooms	
/clatter	clatter	clattering	clatters	
/claw	claw	clawing	claws	
/clean	clean	cleaned	cleaning	cleans	
/cleaner	cleaner	cleaners	
/clear	clear	cleared	clearing	clears	
/clench	clench	clenched	clenches	
/click	click	clicking	clicks	
/client	client	clients	
/cliff	cliff	cliffs	
/climb	climb	climbed	climbing	
/clink	clink	clinking	clinks	
/clip	clip	clipped	clipping	
/clipper	clipper	clippers	
/cloak	cloak	cloaked	cloaks	
/clock	clock	clocks	
/clomp	clomp	clomping	
/clop	clop	clopping	
/close	close	closed	closely	closes	closing	
/closet	closet	closets	
/cloth	cloth	clothed	clothes	clothing	
/cloud	cloud	clouded	clouds	
/cloudsdal	cloudsdale	cloudsdales	
/clown	clown	clowning	clowns	
/club	club	clubs	
/cluck	cluck	clucking	clucks	
/clue	clue	clues	
/clumsi	clumsiness	clumsy	
/clunk	clunk	clunking	
/clutter	clutter	cluttered	cluttering	
/cmc	cmc	cmcs	
/coach	coach	coaching	
/coat	coat	coated	coats	
/cockatric	cockatrice	cockatrices	
/cocoa	cocoa	cocoas	
/cocoon	cocoon	cocooned	
/coddl	coddle	coddling	
/code	code	coded	coding	
/coif	coif	coiffed	
/coil	coil	coils	
/coin	coin	coins	
/coincid	coincidence	coincidences	
/cold	cold	colds	
/collaps	collapse	collapsed	collapses	collapsing	
/collect	collect	collected	collecting	collection	collective	collectively	collects	
/collector	collector	collectors	
/cologn	cologne	colognes	
/color	color	colored	colorful	coloring	coloritis	colors	
/colt	colt	colts	
/column	column	columns	
/comb	comb	combe	combed	
/combin	combination	combine	combined	combines	combining	
/combo	combo	combos	
/come	come	comes	coming	
/comeback	comeback	comebacks	
/comet	comet	comets	
/comfort	comfort	comfortable	comforting	comforts	
/comic	comic	comical	comics	
/command	command	commanded	commander	commanding	commands	
/commemor	commemorate	commemorating	commemorative	
/commend	commend	commendable	
/comment	comment	comments	
/commerci	commercialism	commercialized	
/commit	commit	commitment	commitments	committed	committing	
/committe	committee	committees	
/commun	communicate	communicating	communication	communicator	community	
/companion	companion	companions	
/compar	compare	compared	compares	
/compass	compass	compassion	
/compel	compel	compelled	compelling	
/compet	compete	competed	competent	competing	
/competit	competition	competitions	competitive	
/competitor	competitor	competitors	
/complain	complain	complaining	
/complement	complement	complements	
/complet	complete	completed	completely	completes	
/complic	complicate	complicated	complication	complications	
/compliment	compliment	complimented	complimenting	compliments	
/compromis	compromise	compromising	
/comput	computer	computers	
/con	con	cons	
/concentr	concentrate	concentrated	concentration	
/concern	concern	concerned	concerning	concerns	
/conclud	conclude	concludes	
/conclus	conclusion	conclusions	conclusively	
/condemn	condemn	condemned	
/condit	condition	conditioning	conditions	
/conduct	conducting	conducts	
/confer	confer	conference	conferences	
/confess	confess	confessed	confesses	confessing	confession	confessions	
/confid	confidence	confident	confidently	
/confidant	confidante	confidantes	
/confin	confined	confines	confining	
/confirm	confirm	confirmed	confirming	
/confront	confront	confrontation	confronted	
/confus	confuse	confused	confusing	confusion	
/congratul	congratulate	congratulation	congratulations	
/conjur	conjure	conjured	conjurer	conjures	
/connect	connect	connected	connection	connections	connects	
/conquer	conquer	conquered	conquering	
/consequ	consequence	consequences	
/consid	consider	considered	considering	
/consider	considerable	considerate	consideration	
/consist	consistent	consistently	
/consol	consolation	console	
/constel	constellation	constellations	
/construct	construct	construction	constructive	constructs	
/consult	consult	consultations	consulting	
/consum	consume	consumed	consumer	consumes	consuming	
/contain	contain	contained	containers	containing	contains	
/content	content	contentment	contents	
/contest	contest	contestant	contestants	contests	
/continu	continue	continued	continues	continuing	
/contribut	contribute	contributed	contributing	contribution	contributions	
/control	control	controlled	controlling	controls	
/conundrum	conundrum	conundrums	
/conveni	conveniences	convenient	conveniently	
/convent	convention	conventions	
/convers	conversation	conversations	converse	conversing	conversions	
/convert	convert	converted	
/convey	convey	conveyance	conveys	
/convinc	convince	convinced	convincing	
/coo	coo	cooing	coos	
/cook	cook	cooked	cooking	cooks	
/cookbook	cookbook	cookbooks	
/cooki	cookie	cookies	
/cool	cool	cooled	cooling	coolness	cools	
/coop	coop	cooped	
/cooper	cooperate	cooperation	
/coordin	coordinated	coordination	
/copi	copied	copies	copy	copying	
/core	core	cored	cores	
/corner	corner	cornered	corners	
/correct	correct	corrected	correction	
/corrupt	corrupt	corrupted	corrupts	
/cost	cost	costs	
/costum	costume	costumes	
/cough	cough	coughing	coughs	
/counsel	counsel	counseling	
/count	count	counted	counting	counts	
/counter	counter	countered	
/coupl	couple	couples	
/cousin	cousin	cousins	
/cover	cover	covered	covering	covers	
/cow	cow	cows	
/cowbel	cowbell	cowbells	
/cower	cower	cowering	
/cozi	cozies	cozy	cozying	
/crab	crab	crabs	
/crack	crack	cracked	cracking	cracks	
/cracker	cracker	crackers	
/crackl	crackle	crackles	crackling	
/craft	craft	crafted	crafting	crafts	
/cram	cram	crammed	
/cramp	cramp	cramped	cramping	
/crank	crank	cranked	cranking	
/crash	crash	crashed	crashes	crashing	
/crate	crate	crates	
/crave	crave	craving	
/crawl	crawl	crawling	crawls	
/crayon	crayon	crayons	
/craze	craze	crazed	
/creak	creak	creaking	creaks	
/cream	cream	creams	
/creat	create	created	creates	creating	
/creation	creation	creations	
/creativ	creative	creativity	
/creatur	creature	creatures	
/credit	credit	credits	
/crevass	crevasse	crevasses	
/crew	crew	crews	
/cri	cried	cries	cry	crying	
/cricket	cricket	crickets	
/crime	crime	crimes	
/crisp	crisp	crisps	
/critic	critic	critical	criticism	criticize	
/critter	critter	critters	
/croak	croak	croaking	croaks	
/crochet	crochet	crocheted	
/crook	crook	crooked	
/crop	crop	crops	
/cross	cross	crossed	crosses	crossing	
/crossfad	crossfades	crossfading	
/crow	crow	crowing	crows	
/crowd	crowd	crowded	crowds	
/crown	crown	crowned	crowning	
/cruis	cruise	cruises	cruising	
/crumbl	crumble	crumbles	crumbling	crumbly	
/crunch	crunch	crunches	crunching	
/crusad	crusade	crusader	crusaders	crusading	
/crush	crush	crushed	crushes	crushing	
/crust	crust	crusted	crusts	
/crystal	crystal	crystaller	crystalling	crystallings	crystally	crystals	
/crystallin	crystallin	crystalline	
/cube	cube	cubes	
/cucumb	cucumber	cucumbers	
/cuddl	cuddle	cuddles	cuddling	
/cultur	culture	cultures	
/cup	cup	cups	
/cupcak	cupcake	cupcakes	
/cur	curative	curs	
/cure	cure	cured	cures	curing	
/curl	curl	curled	curling	curls	
/current	current	currently	
/curri	curried	curry	
/curs	curse	cursed	curses	cursing	
/curtain	curtain	curtains	
/cushion	cushion	cushioned	cushions	
/custom	custom	customer	customers	customize	customs	
/cut	cut	cuts	cutting	
/cutter	cutter	cutters	
/cycl	cycle	cycles	
/cymbal	cymbal	cymbals	
/cynic	cynical	cynicism	
/dad	dad	dads	
/daisi	daisies	daisy	
/dam	dam	dams	
/damag	damage	damaged	
/danc	dance	danced	dances	dancing	
/dancer	dancer	dancers	
/dang	dang	danged	
/danger	danger	dangerous	dangerously	
/dare	dare	dared	dares	daring	
/dark	dark	darkness	
/darl	darling	darlings	
/darn	darn	darned	
/dart	dart	darting	
/dash	dash	dashed	dashing	
/date	date	dates	
/day	day	days	
/daydream	daydream	daydreaming	
/daze	daze	dazed	
/dazzl	dazzle	dazzled	dazzling	dazzlings	
/deal	deal	dealing	
/dear	dear	dears	
/deari	dearie	dearies	
/debat	debatable	debate	
/debt	debt	debts	
/debut	debut	debuted	debuting	
/decad	decadence	decades	
/deceiv	deceive	deceiving	
/decid	decide	decided	decides	deciding	
/decis	decision	decisions	
/deck	deck	decks	
/declar	declare	declared	declaring	
/declin	decline	declined	
/decor	decor	decorate	decorated	decorating	decorations	decorative	
/decre	decree	decreed	decrees	
/dedic	dedicate	dedicated	
/deed	deed	deeds	
/defeat	defeat	defeated	defeating	defeats	
/defend	defend	defended	defending	
/defens	defense	defenses	
/defi	defies	defy	defying	
/defin	define	defined	
/definit	definite	definitely	definition	definitive	
/deflat	deflate	deflated	deflates	deflating	deflation	
/degre	degree	degrees	
/delay	delay	delayed	
/deleg	delegate	delegates	delegating	delegation	
/delic	delicate	delicately	
/delicaci	delicacies	delicacy	
/delici	delicious	deliciousness	
/delight	delight	delighted	delightful	delightfully	delighting	delights	
/deliv	deliver	delivered	delivering	
/deliveri	deliveries	delivery	
/demand	demand	demanded	demanding	demands	
/demon	demon	demonic	
/demonstr	demonstrate	demonstrated	demonstration	
/den	den	dens	
/deni	denied	deny	denying	
/dent	dent	dented	dents	
/depart	depart	departed	department	
/depend	depend	dependable	depended	depending	depends	
/depress	depressed	depressing	
/depth	depth	depths	
/der	der	derful	ders	
/deris	derisive	derisively	
/descend	descend	descendants	descending	
/describ	describe	described	describes	describing	
/descript	description	descriptions	descriptive	
/desert	desert	deserted	
/deserv	deserve	deserved	deserves	
/design	design	designated	designed	designer	designers	designing	designs	
/desir	desire	desired	desires	
/desk	desk	desks	
/desper	desperate	desperately	desperation	
/despis	despise	despises	
/despond	despondent	despondently	
/dessert	dessert	desserts	
/destin	destination	destined	
/destini	destinies	destiny	
/destroy	destroy	destroyed	destroying	destroys	
/detail	detail	detailed	details	
/detect	detect	detected	detective	detectives	detects	
/determin	determination	determine	determined	
/devast	devastated	devastating	devastation	
/develop	develop	developed	developing	development	
/devis	devise	devised	
/devot	devote	devoted	devotion	
/devour	devour	devoured	devourer	devouring	
/di	di	dis	
/dial	dial	dials	
/diamond	diamond	diamonds	
/diaper	diaper	diapers	
/diari	diaries	diary	
/die	die	dies	dying	
/diet	diet	diets	
/differ	difference	differences	different	differently	differing	
/dig	dig	digging	digs	
/digest	digest	digested	
/dignitari	dignitaries	dignitary	
/dilig	diligence	diligent	
/dim	dim	dimming	
/dimens	dimension	dimensions	
/dine	dine	dining	
/ding	ding	dinging	dings	
/dinner	dinner	dinners	
/dip	dip	dipped	dips	
/direct	direct	directed	directing	direction	directionally	directions	
/disabl	disable	disabling	
/disadvantag	disadvantage	disadvantaged	
/disagr	disagreement	disagreements	
/disagre	disagree	disagreed	disagreeing	disagrees	
/disappear	disappear	disappearance	disappeared	disappearing	disappears	
/disappoint	disappoint	disappointed	disappointing	disappointment	
/disapprov	disapproves	disapproving	
/disast	disaster	disasters	
/discord	discord	discordant	discorded	discords	
/discov	discover	discovered	discovering	discovers	
/discoveri	discoveries	discovery	
/discuss	discuss	discussed	discussing	discussion	discussions	
/diseas	disease	diseases	
/disgrac	disgrace	disgraced	
/disguis	disguise	disguised	disguises	
/dish	dish	dishes	
/dishonor	dishonor	dishonoring	
/dislodg	dislodge	dislodged	
/dismiss	dismiss	dismissed	
/dispel	dispel	dispelled	dispelling	
/display	display	displayed	displaying	displays	
/disrespect	disrespect	disrespectful	
/disrupt	disrupt	disruptions	disruptive	
/distanc	distance	distances	
/distract	distract	distracted	distracting	distraction	distractions	
/distress	distress	distressed	
/disturb	disturb	disturbed	disturbing	
/ditch	ditch	ditched	ditches	ditching	
/dive	dive	dives	diving	
/divers	diverse	diversion	
/divid	divide	divided	
/divin	divin	divine	
/dizzi	dizziness	dizzy	
/do	do	doing	dos	
/dock	dock	docking	docks	
/doctor	doctor	doctors	
/document	document	documenting	documents	
/dodg	dodge	dodging	
/doe	doe	does	
/dog	dog	dogs	
/doggi	doggie	doggies	
/dogi	dogie	dogies	
/doll	doll	dolls	
/dolphin	dolphin	dolphins	
/domin	dominance	dominate	domination	
/donat	donate	donations	
/done	done	doned	
/dong	dong	donging	
/donut	donut	donuts	
/doom	doom	doomed	dooming	
/door	door	doors	
/doormat	doormat	doormats	
/dot	dot	dots	dotted	
/doubl	double	doubled	doubles	doubling	
/doubt	doubt	doubted	doubting	doubts	
/dove	dove	doves	
/down	down	downed	
/drag	drag	dragged	dragging	drags	
/dragon	dragon	dragons	
/dragonish	dragonish	dragonishness	
/drain	drain	drained	draining	drains	
/drama	drama	dramas	
/dramat	dramatic	dramatical	dramatically	
/drape	draped	drapes	
/draw	draw	drawing	drawings	draws	
/drawer	drawer	drawers	
/dread	dread	dreaded	dreadful	dreadfully	
/dream	dream	dreamed	dreaming	dreams	
/dress	dress	dressed	dresses	dressing	
/dressmak	dressmaker	dressmaking	
/dri	dried	dry	
/drift	drift	drifted	drifting	
/drill	drill	drilling	drills	
/drink	drink	drinking	drinks	
/drip	drip	dripping	
/drive	drive	drives	driving	
/driver	driver	drivers	
/drone	drone	drones	droning	
/drool	drooling	drools	
/drop	drop	dropped	dropping	drops	
/drown	drown	drowned	
/drum	drum	drummed	drumming	drums	
/dub	dub	dubbed	dubs	
/duck	duck	ducked	ducking	ducks	
/duckl	duckling	ducklings	
/dud	dud	duds	
/dude	dude	dudes	
/duel	duel	dueled	duels	
/dull	dull	dullness	
/dumb	dumb	dumbed	
/dumbbel	dumbbell	dumbbells	
/dump	dump	dumped	dumps	
/dumpl	dumpling	dumplings	
/dungeon	dungeon	dungeons	
/duplic	duplicate	duplicates	duplication	
/dust	dust	dusting	
/duti	duties	duty	
/dweeb	dweeb	dweebs	
/dy	dy	dyed	
/dye	dye	dyeing	dyes	
/dynam	dynamic	dynamics	
/eagl	eagle	eagles	
/ear	ear	earring	earrings	ears	
/earn	earn	earned	earning	
/earth	earth	earths	
/eat	eat	eating	eats	
/eavesdrop	eavesdrop	eavesdropping	
/echo	echo	echoed	echoes	echoing	
/eclips	eclipse	eclipsed	
/edg	edge	edges	
/edit	edit	edited	editing	edition	editions	
/educ	education	educational	
/eel	eel	eels	
/effect	effect	effective	effectiveness	effects	
/effici	efficiency	efficient	
/effort	effort	efforts	
/egg	egg	eggs	
/egghead	egghead	eggheads	
/elat	elated	elation	
/elect	elect	elected	election	
/electr	electric	electrical	electricity	
/eleg	elegance	elegant	
/element	element	elemental	elements	
/elimin	eliminate	elimination	
/embarrass	embarrass	embarrassed	embarrassing	embarrassment	
/embellish	embellished	embellishing	
/embrac	embrace	embraced	embracing	
/emerald	emerald	emeralds	
/emerg	emerged	emergency	emerging	
/emot	emoting	emotional	emotionally	emotions	
/empir	empire	empirically	
/employe	employee	employees	
/encas	encased	encases	
/enchant	enchant	enchanted	enchanter	enchanting	enchantment	
/enclosur	enclosure	enclosures	
/encount	encounter	encountered	
/encourag	encourage	encouraged	encouragement	encouraging	
/end	end	ended	ending	ends	
/endang	endanger	endangered	endangering	
/endur	endurance	endure	endured	
/enemi	enemies	enemy	
/engag	engage	engaged	engagement	
/engin	engine	engines	
/enjoy	enjoy	enjoyable	enjoyed	enjoying	enjoyment	enjoys	
/enorm	enormous	enormously	
/enrol	enroll	enrolled	
/ensembl	ensemble	ensembles	
/enslav	enslave	enslaved	enslaving	
/ensur	ensure	ensures	ensuring	
/enter	enter	entered	entering	
/entertain	entertain	entertained	entertaining	entertainment	
/enthusiast	enthusiastic	enthusiasts	
/entir	entire	entirely	
/entranc	entrance	entranced	entrances	
/entri	entries	entry	
/entrust	entrusted	entrusting	
/envelop	envelope	enveloping	
/equal	equal	equality	equalization	equally	equals	
/equat	equate	equates	equation	
/equin	equine	equines	
/eras	erase	erased	erasers	erasing	
/errand	errand	errands	
/error	error	errors	
/erupt	erupted	erupting	
/escap	escape	escaped	escapes	escaping	
/essay	essay	essays	
/essenc	essence	essences	
/essenti	essential	essentials	
/establish	establish	established	establishes	establishment	establishments	
/etern	eternal	eternally	eternity	
/ethic	ethic	ethical	
/evacu	evacuate	evacuating	
/evalu	evaluate	evaluation	
/evapor	evaporate	evaporated	
/eve	eve	eves	
/even	even	evening	evenings	
/event	event	events	
/ever	ever	evers	
/evoc	evocation	evocative	
/evolv	evolve	evolved	
/ewe	ewe	ewes	
/exagger	exaggerated	exaggerating	exaggeration	
/exam	exam	exams	
/examin	examined	examining	
/excel	excel	excellence	excellency	excellent	
/except	except	exception	exceptional	exceptionally	exceptions	
/excess	excess	excessive	
/exchang	exchange	exchanges	exchanging	
/excit	excited	excitement	exciting	
/exclaim	exclaim	exclaiming	exclaims	
/exclam	exclamation	exclamations	
/exclus	exclusive	exclusively	
/excus	excuse	excused	excuses	
/execut	execute	execution	
/exercis	exercise	exercises	
/exhal	exhale	exhales	exhaling	
/exhaust	exhaust	exhausted	exhausting	exhaustion	exhaustive	exhausts	
/exhibit	exhibit	exhibits	
/exist	exist	existed	existence	exists	
/exit	exit	exits	
/expand	expand	expanded	
/expans	expansion	expansions	
/expect	expect	expectations	expected	expecting	expects	
/expel	expelled	expelling	
/expens	expense	expenses	expensive	
/experi	experience	experiences	experiment	experiments	
/experienc	experienced	experiencing	
/experiment	experimental	experimentation	
/expert	expert	experts	
/explain	explain	explained	explaining	explains	
/explan	explanation	explanations	
/explod	explode	exploded	explodes	exploding	
/explor	explore	explored	exploring	
/explos	explosion	explosions	explosive	
/expos	exposed	exposes	
/express	express	expressed	expresses	expressing	expression	expressions	
/exquisit	exquisite	exquisitely	
/extend	extend	extended	extends	
/extens	extension	extensions	extensive	
/extinguish	extinguish	extinguisher	
/extrem	extreme	extremely	
/eye	eye	eyed	eyes	
/eyebal	eyeball	eyeballed	eyeballs	
/eyelash	eyelash	eyelashes	
/fabric	fabric	fabricated	fabrics	
/fabul	fabulous	fabulousness	
/face	face	faced	faces	facing	
/facehoof	facehoof	facehoofs	
/facet	faceted	facets	
/facin	facin	facinating	
/fact	fact	facts	
/fad	fad	fads	
/fade	fade	faded	fades	fading	
/fail	fail	failed	failing	fails	
/failur	failure	failures	
/faint	faint	fainted	fainting	faints	
/fair	fair	faire	
/faith	faith	faithful	
/fake	fake	faked	fakes	faking	
/falcon	falcon	falconer	falcons	
/fall	fall	falling	falls	
/fame	fame	famed	
/famili	families	family	
/fan	fan	fans	
/fanponi	fanponies	fanpony	
/fantasi	fantasies	fantasy	
/fantast	fantastic	fantastical	fantastics	
/fare	fare	fared	
/farewel	farewell	farewells	
/farm	farm	farming	farms	
/farmer	farmer	farmers	
/fashion	fashion	fashionable	fashioned	fashions	
/fashionista	fashionista	fashionistas	
/fast	fast	fasting	
/fate	fate	fateful	
/father	father	fathers	
/favor	favor	favorable	favors	
/favorit	favorite	favorites	
/fear	fear	feared	fearful	fears	
/feast	feast	feasted	
/feat	feat	feats	
/feather	feather	feathered	feathers	
/featur	feature	featured	featuring	
/fedora	fedora	fedoras	
/fee	fee	fees	
/feed	feed	feeding	feeds	
/feel	feel	feeling	feelings	feels	
/fella	fella	fellas	
/feller	feller	fellers	
/fenc	fence	fences	
/fertil	fertile	fertilizer	
/festiv	festival	festivals	festive	festivities	
/fetch	fetch	fetched	fetching	
/fiber	fiber	fibers	
/fiction	fiction	fictional	
/field	field	fields	
/fight	fight	fighting	fights	
/figur	figure	figured	figures	figuring	
/figurin	figurin	figurines	
/file	file	filed	files	filing	
/fill	fill	filled	filling	fills	
/filli	filli	fillies	filly	
/film	film	filmed	filming	
/filter	filter	filtered	
/final	final	finale	finally	finals	
/find	find	finding	findings	finds	
/fine	fine	fines	
/finger	finger	fingers	
/finish	finish	finished	finishes	finishing	
/fire	fire	fired	fires	firing	
/firework	firework	fireworks	
/first	first	firsts	
/fish	fish	fishing	
/fishi	fishies	fishy	
/fit	fit	fits	fitted	fitting	fittings	
/five	five	fives	fiving	
/fix	fix	fixed	fixes	fixing	
/fizzl	fizzle	fizzles	fizzling	
/flag	flag	flags	
/flake	flake	flakes	
/flame	flame	flames	flaming	
/flamingo	flamingo	flamingos	
/flank	flank	flanks	
/flap	flap	flapping	flaps	
/flare	flare	flaring	
/flash	flash	flashes	flashing	
/flashlight	flashlight	flashlights	
/flatten	flatten	flattens	
/flatter	flattered	flatterer	flattering	
/flavor	flavor	flavored	flavors	
/flaw	flaw	flawed	flaws	
/flea	flea	fleas	
/fleck	flecked	flecks	
/fli	flies	fly	flying	
/flick	flick	flicking	flicks	
/flicker	flickering	flickers	
/flip	flip	flipping	flips	
/float	float	floating	floats	
/floati	floatie	floaty	
/flood	flooded	flooding	
/floor	floor	floors	
/flop	flop	flopping	
/flourish	flourish	flourishes	
/flow	flow	flowing	flows	
/flower	flower	flowering	flowers	
/flunk	flunk	flunked	
/flush	flushes	flushing	
/flutter	flutter	fluttering	
/fluttershi	fluttershy	fluttershys	
/flyer	flyer	flyers	
/foal	foal	foals	
/foalsitt	foalsitter	foalsitters	
/focus	focused	focusing	
/fold	fold	folding	folds	
/folk	folk	folks	
/folli	follies	folly	
/follow	follow	followed	follower	followers	following	follows	
/food	food	foods	
/fool	fool	fooled	fooling	fools	
/foolish	foolish	foolishness	
/forc	force	forced	forcefully	forces	forcing	
/forest	forest	forests	
/forev	forev	forever	
/forget	forget	forgets	forgetting	
/forgiv	forgive	forgiveness	forgives	forgiving	
/form	form	formative	formed	forming	forms	
/formal	formal	formality	
/fortun	fortunate	fortunately	fortune	
/forum	forum	forums	
/forward	forward	forwarding	forwardness	forwards	
/fossil	fossil	fossilization	fossils	
/foster	fostered	fostering	
/found	found	founded	founding	
/foundat	foundation	foundations	
/founder	founder	founders	
/fountain	fountain	fountains	
/frame	frame	framed	frames	framing	
/fratern	fraternal	fraternize	
/frazzl	frazzle	frazzled	
/freak	freak	freaked	freaking	freaks	
/freakout	freakout	freakouts	
/free	free	freeing	
/freestyl	freestyle	freestyling	
/freez	freeze	freezing	
/fret	fret	frets	
/fri	fried	fries	fry	
/friend	friend	friends	
/friendship	friendship	friendships	
/fright	fright	frightful	
/frighten	frighten	frightened	frightening	frightens	
/fring	fringe	fringes	
/fritter	fritter	fritters	
/frivol	frivolity	frivolous	
/frock	frock	frocks	
/frog	frog	frogs	
/frost	frost	frosted	frosting	
/frown	frown	frowning	frowns	
/fruit	fruit	fruits	
/frustrat	frustrated	frustrating	frustration	
/fuel	fuel	fueled	fuels	
/fulfil	fulfill	fulfilled	
/function	function	functional	functioning	functions	
/fund	fund	funded	funds	
/fundrais	fundraiser	fundraising	
/fuse	fuse	fuses	
/fuss	fuss	fussing	
/futur	future	futures	
/gag	gag	gagging	gags	
/gain	gain	gained	gaining	gains	
/gal	gal	gals	
/gala	gala	galas	
/gallop	gallop	galloped	galloping	gallops	
/game	game	games	gaming	
/gang	gang	ganging	
/garbl	garble	garbled	
/garden	garden	gardener	gardening	gardens	
/garment	garment	garments	
/gasp	gasp	gasping	gasps	
/gate	gate	gated	gates	
/gather	gather	gathered	gathering	gatherings	
/gaug	gauge	gauging	
/gear	gear	gearing	gears	
/gecko	gecko	geckos	
/gem	gem	gems	
/gemston	gemstone	gemstones	
/genealog	genealogical	genealogy	
/gener	general	generalized	generation	generations	generator	generic	generous	generously	
/genet	genetic	genetically	
/genr	genre	genres	
/gentleponi	gentleponies	gentlepony	
/genuin	genuine	genuinely	
/geod	geode	geodes	
/geolog	geological	geology	
/germ	germ	germs	
/gestur	gesture	gestures	
/get	get	gets	getting	
/geyser	geyser	geysers	
/ghost	ghost	ghosts	
/gift	gift	gifted	gifting	gifts	
/giggl	giggle	giggles	giggling	
/girl	girl	girls	
/girlfriend	girlfriend	girlfriends	
/give	give	gives	giving	
/giver	giver	givers	
/glamor	glamor	glamorous	
/glanc	glance	glanced	
/glass	glass	glasses	
/gleam	gleam	gleaming	gleams	
/glide	glide	gliding	
/glimmer	glimmer	glimmering	
/glint	glint	glints	
/glitter	glitter	glittering	
/glitz	glitz	glitzing	
/gloat	gloat	gloating	
/globe	globe	globes	
/glow	glow	glowed	glowing	glows	
/glug	glug	glugs	
/go	go	going	
/goal	goal	goals	
/goat	goat	goats	
/gobbl	gobble	gobbled	gobbles	gobbling	
/goblet	goblet	goblets	
/goggl	goggle	goggles	
/good	good	goodness	goods	
/goodby	goodbye	goodbyes	
/goodi	goodie	goodies	goody	
/goof	goof	goofing	
/gossip	gossip	gossiping	
/got	got	gots	
/gown	gown	gowns	
/goyl	goyle	goyles	
/grab	grab	grabbed	grabbing	
/grace	grace	graced	graceful	graces	
/grade	grade	grades	grading	
/graduat	graduate	graduated	graduates	graduation	
/grandmar	grandmare	grandmares	
/grandpa	grandpa	grandpas	
/granni	grannies	granny	
/grant	granted	grants	
/grape	grape	grapes	
/grate	grateful	gratefully	
/grave	grave	gravely	
/gray	gray	graying	grays	
/great	great	greatness	
/greet	greet	greeting	greetings	greets	
/griffon	griffon	griffons	
/grin	grin	grins	
/grind	grinding	grinds	
/grip	grip	gripping	
/grit	grit	gritted	
/groan	groan	groaning	groans	
/groceri	groceries	grocery	
/groom	groom	groomed	grooming	
/groov	groove	grooves	
/gross	gross	grossed	
/ground	ground	grounded	grounds	
/group	group	groups	
/grow	grow	growing	grows	
/growl	growl	growling	growls	
/grub	grub	grubs	
/grumbl	grumble	grumbles	grumbling	
/grunt	grunt	grunting	grunts	
/guarante	guarantee	guaranteed	guarantees	
/guard	guard	guarding	guards	
/guardian	guardian	guardians	
/guess	guess	guessed	guesses	guessing	
/guest	guest	guests	
/guid	guide	guided	guides	
/gulp	gulp	gulping	gulps	
/gum	gum	gums	
/gummi	gummies	gummy	
/gun	gun	guns	
/gurgl	gurgle	gurgles	gurgling	
/gust	gust	gusts	
/gut	gut	guts	
/guy	guy	guys	
/ha	ha	has	
/habit	habit	habitation	habits	
/habitat	habitat	habitats	
/hack	hack	hacking	hacks	
/haiku	haiku	haikus	
/hair	hair	haired	hairs	
/hall	hall	halls	
/hallway	hallway	hallways	
/hammer	hammer	hammering	
/hamster	hamster	hamsters	
/hand	hand	handed	handful	handing	hands	
/handkerchief	handkerchief	handkerchiefs	
/handl	handle	handled	handles	handling	
/hang	hang	hanging	hangs	
/hanger	hanger	hangers	
/hangout	hangout	hangouts	
/happen	happen	happened	happening	happenings	happens	
/happi	happiness	happy	
/har	har	harness	harnessed	harnessing	
/hard	hard	hardness	
/harm	harm	harming	
/harmon	harmonize	harmonizing	
/harmoni	harmonies	harmonious	harmony	
/harp	harp	harping	
/harsh	harsh	harshed	harshing	
/harvest	harvest	harvested	harvesting	harvests	
/hast	hast	haste	
/hat	hat	hats	
/hatch	hatch	hatched	hatches	hatching	
/hate	hate	hated	hates	hating	
/haul	haul	hauling	
/haunch	haunch	haunches	
/have	have	haves	having	
/hazard	hazard	hazardous	
/he	he	hes	
/head	head	headed	heading	heads	
/headach	headache	headaches	
/headlin	headline	headliner	headlines	headlining	
/heal	heal	healed	healing	
/healer	healer	healers	
/hear	hear	hearing	hears	
/heart	heart	hearted	hearts	
/hearti	heartie	hearty	
/heat	heat	heated	heating	heats	
/heav	heave	heaves	heaving	
/heaven	heaven	heavens	
/heft	heft	hefted	
/heheh	heheh	hehehe	
/height	height	heights	
/heist	heist	heisting	
/hello	hello	hellos	
/helmet	helmet	helmets	
/help	help	helped	helpful	helping	helps	
/helper	helper	helpers	
/hem	hem	hemmed	hems	
/hen	hen	henning	hens	
/henchponi	henchponies	henchpony	
/her	her	hers	
/herd	herd	herded	herding	
/herder	herder	herders	
/hero	hero	heroes	
/hesit	hesitating	hesitation	
/hex	hex	hexed	
/hi	hi	his	
/hibern	hibernate	hibernating	hibernation	
/hiccup	hiccup	hiccups	
/hide	hide	hides	hiding	
/high	high	highness	
/highlight	highlight	highlighters	highlighting	highlights	
/hightail	hightail	hightailed	
/hill	hill	hills	
/hilltop	hilltop	hilltops	
/hinni	hinnies	hinny	
/hint	hint	hinted	hinting	hints	
/hip	hip	hips	
/hippo	hippo	hippos	
/hippogriff	hippogriff	hippogriffs	
/hire	hire	hired	hiring	
/hiss	hiss	hisses	hissing	
/histor	historic	historical	
/hit	hit	hits	hitting	
/hitch	hitch	hitched	
/hive	hive	hives	
/hoard	hoard	hoarding	
/hock	hock	hocks	
/hog	hog	hogging	
/hold	hold	holding	holds	
/holder	holder	holders	
/hole	hole	holed	holes	
/holiday	holiday	holidays	
/holler	holler	hollering	
/hologram	hologram	holograms	
/home	home	homes	
/honk	honk	honked	honking	honks	
/honor	honor	honorable	honored	honoring	
/hoo	hoo	hooing	
/hoof	hoof	hoofed	hoofs	
/hooffield	hooffield	hooffields	
/hooficur	hooficure	hooficures	
/hoofington	hoofington	hoofingtons	
/hoofstep	hoofstep	hoofsteps	
/hook	hook	hooked	hooks	
/hoop	hoop	hooping	hoops	
/hoot	hoot	hooting	hoots	
/hoov	hooved	hooves	
/hop	hop	hopping	
/hope	hope	hoped	hopefully	hopes	hoping	
/horn	horn	horned	horns	
/hornet	hornet	hornets	
/horrend	horrendous	horrendously	
/horribl	horrible	horribly	
/horrifi	horrified	horrifying	
/horror	horror	horrors	
/hors	horse	horses	horsing	
/horsesho	horseshoe	horseshoes	
/hospit	hospitable	hospital	hospitality	
/host	host	hosted	hosting	hosts	
/hour	hour	hours	
/hous	house	housed	houses	
/hover	hovering	hovers	
/howl	howl	howling	howls	
/huff	huff	huffs	
/hug	hug	hugging	hugs	
/hum	hum	humming	hums	
/humbl	humble	humbled	humbly	
/humili	humiliate	humiliated	humiliating	humiliation	
/hummingbird	hummingbird	hummingbirds	
/humor	humor	humorous	
/hundr	hundred	hundreds	
/hunk	hunk	hunks	
/hunt	hunt	hunted	hunting	hunts	
/hunter	hunter	hunters	
/hurl	hurl	hurled	
/hurri	hurried	hurry	
/hurrican	hurricane	hurricanes	
/hurt	hurt	hurtful	hurting	hurts	
/hush	hush	hushed	
/hustl	hustle	hustled	
/hydra	hydra	hydras	
/hyperventil	hyperventilate	hyperventilated	hyperventilates	hyperventilating	
/hyster	hysterical	hysterically	hysterics	
/ice	ice	iced	icing	
/icki	ickiness	icky	
/idea	idea	ideas	
/ideal	ideal	ideally	ideals	
/identifi	identified	identify	identifying	
/ignit	ignite	ignited	igniter	ignites	igniting	
/ignor	ignorant	ignore	ignored	ignoring	
/ill	ill	illness	illnesses	
/illus	illusion	illusions	
/illustr	illustrates	illustrations	
/imag	image	images	
/imagin	imagination	imaginations	imagine	imagined	imagining	
/imit	imitate	imitates	imitating	imitation	
/immedi	immediate	immediately	
/immort	immortal	immortality	immortalized	
/impenetr	impenetrability	impenetrable	
/import	import	importance	important	imported	
/impos	impose	imposing	
/imposs	impossibilities	impossible	impossibly	
/impress	impress	impressed	impression	impressions	impressive	
/imprison	imprison	imprisoned	imprisonment	
/improb	improbability	improbable	
/improv	improve	improved	improvement	improvements	improving	
/improvis	improvisation	improvise	
/in	in	ins	
/incant	incantation	incantations	
/inch	inch	inches	
/inciner	incinerated	incinerates	
/includ	include	included	includes	including	
/inclus	inclusions	inclusive	
/incoher	incoherent	incoherently	
/inconveni	inconvenience	inconveniently	
/increas	increase	increased	increases	
/incred	incredible	incredibly	
/index	index	indexed	
/indic	indicated	indicating	indication	
/indign	indignant	indignation	
/individu	individual	individually	
/indulg	indulge	indulgent	
/industri	industrial	industrious	industry	
/inevit	inevitable	inevitably	
/infect	infect	infected	infecting	infection	
/infest	infestation	infestations	infests	
/infinit	infinite	infinitely	
/inflat	inflatable	inflated	inflates	inflating	
/influenc	influence	influenced	
/inform	inform	informal	information	informing	
/ing	ing	ings	
/ingredi	ingredient	ingredients	
/inhal	inhalation	inhale	inhales	inhaling	
/initi	initial	initially	initials	initiation	initiative	
/injuri	injuries	injury	
/inn	inn	inns	
/innoc	innocence	innocent	innocently	
/insan	insane	insanely	
/insid	inside	insider	
/insight	insight	insightful	
/insincer	insincere	insincerely	
/insist	insist	insisted	insists	
/inspect	inspected	inspecting	
/inspector	inspector	inspectors	
/inspir	inspiration	inspirational	inspire	inspired	inspires	inspiring	
/instal	install	installation	installed	
/instinct	instinct	instincts	
/institut	institute	institution	institutions	
/instruct	instruction	instructions	
/instrument	instrument	instrumental	instruments	
/insult	insult	insulted	insulting	insults	
/integr	integral	integration	integrity	
/intellig	intelligence	intelligent	
/intend	intend	intended	intends	
/intens	intense	intensely	
/intensifi	intensifies	intensify	
/intent	intent	intention	intentioned	intentions	intents	
/interact	interact	interacting	interaction	
/interest	interest	interested	interesting	interests	
/interfer	interfere	interferes	
/intern	intern	internal	internally	international	
/interrupt	interrupt	interrupted	interrupting	interruption	interruptions	interrupts	
/interview	interview	interviewed	
/intimid	intimidate	intimidated	intimidating	intimidation	
/inton	intonation	intonements	
/intrigu	intrigue	intrigued	intriguing	
/introduc	introduce	introduced	introducing	
/introduct	introduction	introductions	
/intrud	intruded	intruder	intruders	intruding	
/invad	invaded	invading	
/invent	invent	invented	inventing	invention	inventive	
/investig	investigate	investigates	investigating	investigation	
/invis	invisibility	invisible	
/invit	invitation	invitations	invite	invited	invites	inviting	
/involv	involve	involved	involves	
/iron	iron	ironic	
/irrit	irritably	irritated	
/issu	issue	issues	
/it	it	its	
/itch	itch	itches	itching	
/item	item	items	
/ith	ith	ithing	
/iti	itis	ity	
/ja	ja	jas	
/jack	jack	jacking	
/jacket	jacket	jackets	
/jackhamm	jackhammer	jackhammering	jackhammers	
/jam	jam	jams	
/jangl	jangle	jangling	
/jar	jar	jars	
/jaw	jaw	jaws	
/jellybean	jellybean	jellybeans	
/jerk	jerk	jerks	
/jewel	jewel	jewels	
/jiggl	jiggle	jiggles	jiggling	
/jingl	jingle	jingles	jingling	
/job	job	jobs	
/jockey	jockey	jockeying	
/join	join	joined	joining	joins	
/joint	joint	joints	
/joke	joke	jokes	joking	
/joker	joker	jokers	
/jolt	jolt	jolts	
/journal	journal	journalism	journals	
/journey	journey	journeys	
/joy	joy	joyful	joys	
/judg	judge	judged	judges	judging	
/judgment	judgment	judgmental	
/juggl	juggle	juggling	
/juic	juice	juices	
/jump	jump	jumped	jumping	
/junebug	junebug	junebugs	
/jungl	jungle	jungles	
/kablam	kablam	kablammed	
/karat	karat	karate	
/kayak	kayak	kayaking	
/kazoo	kazoo	kazoos	
/keep	keep	keeping	keeps	
/keeper	keeper	keepers	
/kernel	kernel	kernels	
/key	key	keys	
/kick	kick	kicked	kicking	kicks	
/kid	kid	kidding	kids	
/kidnap	kidnapped	kidnapping	
/kill	killing	kills	
/kin	kin	kins	
/kind	kind	kindness	kinds	
/kingdom	kingdom	kingdoms	
/kiss	kiss	kissed	kisses	kissing	
/kitchen	kitchen	kitchens	
/kite	kite	kites	
/kitti	kitties	kitty	
/klugetown	klugetown	klugetowner	klugetowners	
/knee	knee	knees	
/knit	knit	knitted	knitting	
/knock	knock	knocked	knocking	knocks	
/know	know	knowing	knows	
/knucklehead	knucklehead	knuckleheads	
/la	la	las	
/label	label	labeled	
/lack	lack	lacked	lacking	lacks	
/ladder	ladder	ladders	
/ladi	ladies	lady	
/ladybug	ladybug	ladybugs	
/lake	lake	lakes	
/lame	lame	lameness	
/lamp	lamp	lamps	
/land	land	landed	landing	lands	
/lane	lane	lanes	
/lantern	lantern	lanterns	
/lap	lap	lapped	laps	
/laser	laser	lasers	
/lash	lash	lashed	lashes	lashing	
/last	last	lasting	lasts	
/late	late	lately	
/later	later	laters	
/laugh	laugh	laughed	laughing	laughs	
/launch	launch	launched	launches	launching	
/law	law	lawfully	laws	
/lay	lay	laying	lays	
/layer	layer	layers	
/le	le	les	
/lead	lead	leading	leads	
/leader	leader	leaders	
/leak	leak	leaking	leaks	
/lean	lean	leaning	leans	
/leap	leap	leaped	leaping	
/learn	learn	learned	learning	learns	
/leav	leave	leaves	leaving	
/lectur	lecture	lectured	lectures	
/leg	leg	legged	leggings	legs	
/legend	legend	legends	
/lemon	lemon	lemons	
/lend	lend	lending	
/lesson	lesson	lessons	
/let	let	lets	letting	
/letter	letter	letters	
/level	level	levels	
/levit	levitating	levitation	
/li	li	lis	
/librari	libraries	library	
/librarian	librarian	librarians	
/lick	lick	licked	licking	licks	
/lie	lie	lied	lies	lying	
/lifeboat	lifeboat	lifeboats	
/lifesav	lifesaver	lifesaving	
/lift	lift	lifted	lifting	lifts	
/light	light	lighting	lights	
/like	like	liked	likely	likeness	likes	liking	
/lili	lilies	lily	
/limb	limb	limbed	limbs	
/limit	limit	limitations	limited	limits	
/line	line	lined	lines	lining	
/linen	linen	linens	
/link	link	linked	
/lion	lion	lions	
/lisp	lisp	lisping	
/list	list	lists	
/listen	listen	listened	listener	listening	listens	
/liter	literal	literally	
/live	live	lived	lively	lives	living	
/load	load	loads	
/loan	loan	loaned	
/local	local	locale	locally	locals	
/locat	locate	located	locating	location	locations	locator	
/lock	lock	locked	locking	locks	
/log	log	logged	logs	
/lollipop	lollipop	lollipops	
/lone	lone	lonely	
/long	long	longed	
/look	look	looked	looking	looks	
/looki	lookie	looky	
/loop	loop	looped	loops	
/lose	lose	loses	losing	
/loser	loser	losers	
/loss	loss	losses	
/lot	lot	lots	
/loung	lounge	lounging	
/love	love	loved	lovely	loves	loving	
/lovey	lovey	loveys	
/lower	lower	lowered	lowering	
/lump	lump	lumps	
/lunch	lunch	lunches	
/lurk	lurk	lurking	lurks	
/lux	lux	luxe	
/luxuri	luxuriating	luxurious	luxury	
/machin	machine	machines	
/mad	mad	madness	
/madam	madam	madame	
/mage	mage	mages	
/magic	magic	magical	magically	magics	
/magician	magician	magicians	
/magnet	magnet	magnetic	
/magnifi	magnifies	magnifying	
/magnific	magnificence	magnificent	
/mail	mail	mailing	mails	
/maintain	maintain	maintained	maintainer	
/majesti	majesties	majesty	
/make	make	makes	making	
/makeov	makeover	makeovers	
/maker	maker	makers	
/mama	mama	mamas	
/manag	manage	managed	management	manager	managers	manages	managing	
/mane	mane	manes	
/manehattanit	manehattanite	manehattanites	
/maniac	maniacal	maniacally	
/manipul	manipulate	manipulated	manipulative	
/mannequin	mannequin	mannequins	
/manner	manner	mannered	manners	
/map	map	mapped	mapping	maps	
/march	march	marched	marching	
/mare	mare	mared	mares	
/margin	margin	marginally	
/marin	marinated	marine	
/mark	mark	marked	marks	
/market	market	marketing	
/marri	married	marry	marrying	
/marshmallow	marshmallow	marshmallows	
/marvel	marvel	marveling	marvelous	
/mash	mash	mashed	mashing	
/mask	mask	masked	masks	
/massag	massage	massages	
/master	master	mastered	masterful	masters	
/match	match	matched	matches	matching	
/mate	mate	mates	
/materi	material	materialize	materials	
/matey	matey	mateys	
/matter	matter	mattered	matters	
/mattress	mattress	mattresses	
/matur	mature	matured	
/maulwurf	maulwurf	maulwurfs	
/mayb	maybe	maybes	
/maze	maze	mazes	
/mcbiggun	mcbiggun	mcbigguns	
/mccolt	mccolt	mccolts	
/me	me	mes	
/meal	meal	meals	
/mean	mean	meaning	meanness	means	
/meani	meanie	meanies	
/measur	measure	measured	measurements	measures	measuring	
/mechan	mechanical	mechanically	mechanism	
/medal	medal	medals	
/medalist	medalist	medalists	
/medallion	medallion	medallions	
/meddl	meddled	meddling	
/medic	medic	medical	
/meet	meet	meeting	meetings	meets	
/melodi	melodies	melody	
/melt	melt	melted	melting	melts	
/member	member	members	
/memor	memorable	memorized	
/memori	memorial	memories	memory	
/mend	mend	mended	mending	
/mention	mention	mentioned	mentioning	mentions	
/mentor	mentor	mentoring	
/menu	menu	menus	
/meow	meow	meowing	meows	
/mere	mere	merely	
/meringu	meringue	meringues	
/mess	mess	messed	messes	messing	
/messag	message	messages	
/messi	messiness	messy	
/metal	metal	metallic	
/metaphor	metaphor	metaphorical	metaphors	
/method	method	methodical	methods	
/mew	mewing	mews	
/mewl	mewl	mewling	mewls	
/microphon	microphone	microphones	
/migrat	migrate	migration	
/miladi	miladies	milady	
/mile	mile	miles	
/milk	milk	milked	milking	
/milkshak	milkshake	milkshakes	
/million	million	millions	
/mime	mimes	miming	
/mind	mind	minded	minding	minds	
/miner	miner	mineralization	minerals	miners	
/mingl	mingle	mingled	mingling	
/mini	mini	minis	
/minion	minion	minions	
/mint	mint	mints	
/minut	minute	minutes	
/mirror	mirror	mirrors	
/mischiev	mischievous	mischievously	
/miser	miserable	miserably	
/misjudg	misjudge	misjudged	misjudging	misjudgment	
/mispronounc	mispronounced	mispronouncing	
/miss	miss	missed	misses	missing	
/mission	mission	missions	
/mist	mist	mists	
/mistak	mistake	mistakes	
/misunderstand	misunderstand	misunderstanding	
/mite	mite	mites	
/mix	mix	mixed	mixes	mixing	
/mixtur	mixture	mixtures	
/moan	moan	moaning	moans	
/mob	mob	mobbed	
/mock	mock	mocking	mocks	
/model	model	modeled	modeling	modelle	models	
/moder	moderate	moderation	
/moistur	moisture	moisturizers	
/mold	mold	molded	
/molt	molt	molting	molts	
/molter	molter	molters	
/moment	moment	momentous	moments	
/monkey	monkey	monkeys	
/monster	monster	monsters	
/month	month	months	
/moo	moo	mooing	moos	
/moon	moon	moons	
/mop	mop	mopped	
/moral	moral	morale	moralizing	
/more	more	mores	
/morn	morning	mornings	
/mortifi	mortified	mortifying	
/mosey	mosey	moseying	
/mother	mother	mothers	
/motiv	motivate	motivated	motivating	motivation	motivational	motivations	motive	
/motor	motor	motoring	motorized	
/motorbik	motorbike	motorbikes	
/mountain	mountain	mountainous	mountains	
/mouth	mouth	mouthful	mouths	
/move	move	moved	moves	moving	
/movi	movie	movies	
/mr	mr	mrs	
/muddi	muddied	muddy	muddying	
/muffin	muffin	muffins	
/mule	mule	mules	
/mull	mulled	mulling	
/multipli	multiplies	multiply	multiplying	
/mumbl	mumble	mumbles	mumbling	
/munch	munch	munches	munching	
/murmur	murmuring	murmurs	
/muscl	muscle	muscles	
/muse	muse	muses	
/museum	museum	museums	
/music	music	musical	musicality	musicals	
/musician	musician	musicians	
/mutt	mutt	mutts	
/mutter	muttered	muttering	mutterings	mutters	
/mysteri	mysteries	mysterious	mysteriously	mystery	
/mystic	mystic	mystical	
/nacho	nacho	nachos	
/nail	nail	nailed	nailing	nails	
/name	name	named	namely	names	
/nana	nana	nanas	
/nap	nap	napped	napping	naps	
/napkin	napkin	napkins	
/narrat	narrate	narrating	narrator	
/narrow	narrow	narrowed	narrowing	
/nation	nation	national	nations	
/natur	natural	naturally	naturals	nature	
/navig	navigate	navigation	
/neat	neat	neatness	
/neck	neck	necks	
/necklac	necklace	necklaces	
/need	need	needed	needing	needs	
/needl	needle	needles	
/neg	negative	negatively	negativity	
/negoti	negotiable	negotiator	
/neigh	neigh	neighing	neighs	
/neighbor	neighbor	neighboring	neighbors	
/neighsay	neighsay	neighsayers	
/nerd	nerd	nerds	
/nerv	nerve	nerves	
/nest	nest	nested	nesting	nests	
/newbi	newbie	newbies	
/nibbl	nibble	nibbles	nibblies	
/nice	nice	nicely	
/nicknam	nickname	nicknames	
/night	night	nights	
/nightmar	nightmare	nightmared	nightmares	
/nincompoop	nincompoop	nincompoops	
/nirik	nirik	niriks	
/nod	nod	nodded	
/noi	noi	noies	
/nois	noise	noises	
/noisemak	noisemaker	noisemakers	
/nom	nom	nomming	
/noodl	noodle	noodles	
/normal	normal	normally	
/nose	nose	noses	
/not	not	nots	
/note	note	noted	notes	noting	
/notebook	notebook	notebooks	
/noth	nothing	nothings	
/notic	notice	noticed	notices	noticing	
/notori	notorious	notoriously	
/novel	novel	novels	
/nowher	nowhere	nowheres	
/nuanc	nuance	nuanced	nuances	
/nudg	nudge	nudging	
/number	number	numbers	
/numbskul	numbskull	numbskulls	
/nurs	nurse	nurses	
/nut	nut	nuts	
/oat	oat	oats	
/obedi	obedience	obediently	
/obey	obey	obeys	
/object	object	objective	objects	
/oblig	obligation	obligations	obliged	
/obscur	obscure	obscured	
/observ	observant	observation	observational	observe	observer	observing	
/obsess	obsess	obsessed	obsessing	obsession	
/obstacl	obstacle	obstacles	
/occasion	occasional	occasionally	
/occur	occur	occurring	occurs	
/odd	odd	odds	
/oeuvr	oeuvre	oeuvres	
/offend	offend	offended	
/offens	offense	offensive	
/offer	offer	offered	offering	offers	
/offic	office	officers	
/offici	official	officially	officiate	officiating	
/oink	oink	oinking	oinks	
/old	old	olde	
/omelett	omelette	omelettes	
/omin	ominous	ominously	
/one	one	ones	
/ooh	ooh	oohing	oohs	
/oop	oop	oops	
/oopsi	oopsie	oopsies	
/open	open	opened	opener	opening	openings	opens	
/operat	operatic	operatically	
/opinion	opinion	opinions	
/opportun	opportunities	opportunity	
/opposit	opposite	opposites	
/oppress	oppression	oppressive	
/optim	optimal	optimism	
/option	option	optional	options	
/orang	orange	oranges	
/orchard	orchard	orchards	
/orchestr	orchestral	orchestrating	
/order	order	ordered	ordering	orders	
/organ	organ	organic	organisms	organization	organize	organized	organizer	organizes	organizing	
/orient	oriental	oriented	
/origin	origin	original	originality	originally	originals	
/ornament	ornament	ornaments	
/other	other	others	
/our	our	ours	
/out	out	outed	outs	
/outdoor	outdoor	outdoors	
/outfit	outfit	outfits	
/outlin	outline	outlined	
/outrag	outrageous	outrageously	
/outshin	outshine	outshined	outshines	
/outsid	outside	outsiders	
/outsmart	outsmart	outsmarted	outsmarts	
/oven	oven	ovens	
/overdo	overdo	overdoes	overdoing	
/overhear	overhear	overhearing	
/overlap	overlapped	overlapping	
/overlook	overlooked	overlooking	
/overpack	overpack	overpacked	
/overreact	overreacted	overreacting	
/overse	oversee	overseeing	
/overwhelm	overwhelm	overwhelmed	overwhelming	overwhelms	
/owe	owe	owed	owes	owing	
/owl	owl	owls	
/own	own	owning	owns	
/owner	owner	owners	
/pace	pace	paced	paces	pacing	
/pack	pack	packed	packing	packs	
/packag	package	packages	
/pad	pad	pads	
/page	page	pages	
/pageant	pageant	pageants	
/pain	pain	pained	painful	painfully	pains	
/paint	paint	painted	painting	paintings	paints	
/pair	pair	paired	pairing	pairs	
/pal	pal	pals	
/pale	pale	pales	
/pamper	pamper	pampered	pampering	
/pan	pan	pans	
/pancak	pancake	pancakes	
/panel	panel	panels	
/panic	panic	panics	
/panick	panicked	panicking	
/pant	pant	panting	pants	
/papa	papa	papas	
/paper	paper	papers	
/parad	parade	parading	
/parasprit	parasprite	parasprites	
/parchment	parchment	parchments	
/pardon	pardon	pardons	
/parent	parent	parental	parents	
/park	park	parking	
/parrot	parrot	parrots	
/parsnip	parsnip	parsnips	
/part	part	parted	parting	parts	
/parti	partied	parties	party	partying	
/particip	participant	participate	participating	participation	
/partner	partner	partnered	partnering	partners	
/pass	pass	passed	passes	passing	
/passag	passage	passages	
/passeng	passenger	passengers	
/passion	passion	passionate	passions	
/past	past	paste	pastelis	
/pastri	pastries	pastry	
/pastur	pasture	pastures	
/pat	pat	patting	
/patch	patch	patched	patches	
/patent	patent	patented	
/path	path	paths	
/patient	patient	patiently	patients	
/patrol	patrol	patrolling	patrols	
/patron	patron	patrons	
/pattern	pattern	patterns	
/paus	pause	pauses	
/paw	paw	paws	
/pay	pay	paying	
/payment	payment	payments	
/pea	pea	peas	
/peac	peace	peaceful	peacefully	
/peach	peach	peaches	
/peacock	peacock	peacocks	
/peak	peak	peaks	
/peanut	peanut	peanuts	
/pear	pear	pears	
/pearl	pearl	pearls	
/pebbl	pebble	pebbles	
/peck	peck	pecking	
/pedi	pedi	pedied	
/peel	peel	peeled	peels	
/peer	peer	peered	peers	
/pen	pen	penned	pens	
/pencil	pencil	pencils	
/pendant	pendant	pendants	
/percept	perceptible	perception	perceptive	
/perfect	perfect	perfected	perfection	
/perform	perform	performance	performances	performed	performer	performers	performing	performs	
/peril	peril	perilous	
/period	period	periodically	
/perk	perk	perks	
/perman	permanence	permanent	permanently	
/permiss	permission	permissions	
/person	person	personal	personalities	personality	personalized	personally	
/perspect	perspective	perspectives	
/persuad	persuade	persuading	
/pet	pet	pets	petting	
/petal	petal	petals	
/petit	petition	petitions	
/petrifi	petrified	petrify	petrifying	
/petunia	petunia	petunias	
/phase	phase	phasing	
/phoenix	phoenix	phoenixes	
/phone	phone	phones	
/photo	photo	photos	
/photograph	photograph	photographer	photographs	
/photoshoot	photoshoot	photoshoots	
/physic	physical	physically	physics	
/pick	pick	picked	picking	picks	
/pickl	pickle	pickled	pickles	
/pictur	picture	pictured	pictures	picturing	
/pie	pie	pies	
/piec	piece	pieces	
/pig	pig	pigs	
/pile	pile	piled	piles	piling	
/pilgrimag	pilgrimage	pilgrimaging	
/pillar	pillar	pillars	
/pillow	pillow	pillows	
/pin	pin	pinned	pins	
/pinch	pinch	pinched	pinching	
/pine	pine	pining	
/pineappl	pineapple	pineapples	
/ping	ping	pinging	pings	
/pink	pink	pinks	
/pinki	pinki	pinkie	pinkies	pinky	
/pipe	pipe	pipes	
/pirat	pirate	pirates	
/pirouett	pirouette	pirouettes	
/pistachio	pistachio	pistachios	
/pit	pit	pits	
/pitch	pitch	pitched	pitches	pitching	
/piti	pitiful	pity	
/piã±ata	piã±ata	piã±atas	
/place	place	placed	places	placing	
/plagu	plague	plagued	plagues	
/plan	plan	planned	planning	plans	
/planet	planet	planets	
/plank	plank	planks	
/planner	planner	planners	
/plant	plant	planted	planting	plants	
/plate	plate	plated	plates	
/platform	platform	platforms	
/play	play	played	playful	playing	plays	
/player	player	players	
/plead	plead	pleading	
/pleas	please	pleased	pleasing	
/pleasur	pleasure	pleasures	
/pleat	pleated	pleats	
/plop	plop	plopping	plops	
/plot	plot	plotted	plotting	
/plow	plow	plowing	
/pluck	pluck	plucked	
/plug	plug	plugged	
/plumb	plumb	plumbing	
/po	po	poing	
/pocket	pocket	pockets	
/pod	pod	pods	
/poem	poem	poems	
/point	point	pointed	pointing	points	
/pointer	pointer	pointers	
/poison	poison	poisoned	poisonous	
/poke	poke	poked	poking	
/polish	polish	polished	
/polit	polite	politely	political	politics	
/poncho	poncho	ponchos	
/poni	ponied	ponies	pony	
/poodl	poodle	poodles	
/poof	poof	poofing	poofs	
/pool	pool	pools	
/pooper	pooper	poopers	
/pop	pop	popped	popping	pops	
/popul	populated	population	
/popular	popular	popularity	
/porcupin	porcupine	porcupines	
/portal	portal	portals	
/pose	pose	posed	posing	
/posit	position	positions	positive	positively	positives	positivity	
/possess	possess	possessed	possessing	possession	possessions	possessive	
/possibl	possibilities	possibility	possible	possibly	
/post	post	posted	posts	
/postcard	postcard	postcards	
/poster	poster	posters	
/postpon	postpone	postponed	
/pot	pot	pots	potted	
/potato	potato	potatoes	
/potenti	potential	potentially	
/potion	potion	potions	
/pouch	pouch	pouches	
/poultic	poultice	poultices	
/pound	pound	pounding	pounds	
/pour	pour	poured	pouring	pours	
/pout	pout	pouting	
/powder	powder	powdered	
/power	power	powered	powerful	powering	powers	
/practic	practical	practicality	practically	practice	practiced	practices	practicing	
/prais	praise	praises	
/pranc	prance	prances	prancing	
/prank	prank	pranked	pranking	pranks	
/precis	precise	precisely	precision	
/predat	predator	predators	
/predict	predict	predictable	predicted	prediction	predictions	
/prefer	prefer	preferable	preferably	prefers	
/premier	premier	premiere	
/prep	prep	prepping	
/prepar	preparation	preparations	prepare	prepared	prepares	preparing	
/presenc	presence	presences	
/present	present	presentation	presented	presenting	presents	
/preserv	preservation	preserve	preserved	preserving	
/presid	president	presiding	
/press	press	pressed	presses	
/pressur	pressure	pressured	pressures	pressuring	
/pretend	pretend	pretended	pretending	
/pretti	pretties	pretty	
/pretzel	pretzel	pretzels	
/prevail	prevail	prevailed	prevails	
/prevent	prevent	prevented	preventing	
/price	price	prices	
/prick	prick	pricking	
/pride	pride	prided	prides	
/prim	prim	primmed	
/princ	prince	princely	princes	
/princess	princess	princesses	princessness	
/princip	principal	principals	
/print	print	printed	printing	prints	
/prioriti	priorities	priority	
/prison	prison	prisoner	prisoners	
/privileg	privilege	privileges	
/prize	prize	prized	prizes	
/probabl	probabilities	probably	
/problem	problem	problems	
/process	process	processing	procession	
/proclaim	proclaim	proclaimed	
/procur	procure	procurement	
/produc	produce	produced	produces	
/product	product	production	productive	productivity	
/profession	professional	professionalism	professionally	professionals	
/professor	professor	professors	
/profit	profitable	profits	
/program	program	programs	
/progress	progress	progression	progressively	
/project	project	projecting	projects	
/promis	promise	promised	promises	promising	
/promot	promote	promoted	promoting	promotion	
/pronounc	pronounce	pronounced	pronouncing	
/proof	proof	proofed	proofing	
/prop	prop	props	
/propel	propelled	propelling	
/properti	properties	property	
/propheci	prophecies	prophecy	
/propos	proposal	proposals	propose	proposed	proposing	
/protect	protect	protected	protecting	protection	protective	protects	
/protest	protest	protesting	
/prove	prove	proved	proves	proving	
/provid	provide	provided	providence	provider	provides	providing	
/prune	prune	pruning	
/psych	psych	psyche	psyched	
/psychic	psychic	psychically	
/publish	publish	published	publisher	
/pucker	puckered	puckering	
/puckwudgi	puckwudgie	puckwudgies	
/pud	pudding	puddings	
/puddl	puddle	puddles	
/puf	puffed	puffing	
/puff	puff	puffs	
/pull	pull	pulled	pulling	pulls	
/pump	pump	pumped	pumping	
/pumpkin	pumpkin	pumpkining	pumpkins	
/pun	pun	puns	
/punch	punch	punched	punches	punching	
/punctual	punctual	punctuality	
/punish	punish	punished	punishment	
/punk	punk	punks	
/puppet	puppet	puppeteer	puppets	
/puppi	puppies	puppy	
/purchas	purchase	purchasing	
/pure	pure	purely	
/purpos	purpose	purposes	purposing	
/purr	purr	purrs	
/pursu	pursue	pursued	pursuing	
/pursuit	pursuit	pursuits	
/push	push	pushed	pushes	pushing	
/put	put	puts	putting	
/puzzl	puzzle	puzzles	puzzling	
/pyramid	pyramid	pyramids	
/quack	quack	quacking	quacks	
/quadrupl	quadruple	quadruplicates	
/qualifi	qualified	qualifies	qualify	qualifying	
/qualiti	qualities	quality	
/quarter	quarter	quarters	
/queen	queen	queens	
/quesadilla	quesadilla	quesadillas	
/quest	quest	quests	
/question	question	questioned	questioning	questions	
/quiet	quiet	quiets	
/quill	quill	quills	
/quilt	quilt	quilting	quilts	
/quit	quit	quite	quits	quitting	
/rabbit	rabbit	rabbits	
/raccoon	raccoon	raccoons	
/race	race	raced	races	racing	
/racer	racer	racers	
/rack	rack	racked	racking	
/radic	radical	radicalness	
/rag	rag	ragged	
/rage	rage	raged	raging	
/rain	rain	rained	raining	rains	
/rainboom	rainboom	rainbooming	rainbooms	
/rainbow	rainbow	rainbowed	rainbows	
/rais	raise	raised	raises	raising	
/rake	rake	rakes	raking	
/ralli	rallied	rallies	rallying	
/rap	rap	rapping	
/rare	rare	rarely	raring	
/raspberri	raspberries	raspberry	
/rat	rat	rats	
/rate	rate	rated	rates	rating	
/ration	ration	rational	
/rattl	rattle	rattled	rattles	rattling	
/rave	raved	raves	raving	
/ray	ray	rays	
/reach	reach	reached	reaches	reaching	
/react	react	reacted	
/reaction	reaction	reactions	
/read	read	reading	readings	reads	
/reader	reader	readers	
/realist	realist	realistic	
/realiz	realization	realize	realized	realizes	realizing	
/reappli	reapply	reapplying	
/rear	rear	rears	
/rearrang	rearrange	rearranging	
/reason	reason	reasonable	reasonably	reasoning	reasons	
/reassur	reassured	reassuring	
/recalibr	recalibrate	recalibrating	
/receiv	receive	received	receives	receiving	
/recent	recent	recently	
/recept	reception	receptions	
/recess	recess	recessed	
/recheck	recheck	rechecked	
/recip	recipe	recipes	
/recit	recital	recite	reciting	
/reckon	reckon	reckoned	
/recogn	recognize	recognized	
/recommend	recommend	recommendations	recommended	recommending	recommends	
/reconcil	reconcile	reconciled	
/reconnect	reconnect	reconnecting	
/record	record	recorded	recorder	recording	records	
/recov	recover	recovered	recovers	
/recreat	recreate	recreated	recreation	
/red	red	redness	
/redecor	redecorate	redecorating	
/redeem	redeem	redeemed	
/redesign	redesign	redesigning	
/reenact	reenacted	reenacting	reenactment	
/refer	refer	reference	referring	refers	
/refin	refine	refined	refinement	refinements	
/reflect	reflect	reflected	reflection	reflections	reflective	
/reform	reform	reformed	reforming	
/refresh	refresh	refreshing	refreshment	refreshments	
/refus	refuse	refused	refuses	refusing	
/regal	regal	regality	regally	
/regret	regret	regrets	regretting	
/rehears	rehearsal	rehearse	rehearsing	
/reign	reign	reigning	reigns	
/rein	rein	reins	
/reinforc	reinforce	reinforced	reinforcements	reinforces	
/reject	reject	rejected	rejecting	
/rejuven	rejuvenate	rejuvenates	
/rekindl	rekindled	rekindling	
/rel	relatively	relatives	
/relat	relatable	relate	related	relates	relation	relations	
/relationship	relationship	relationships	
/relax	relax	relaxation	relaxed	relaxes	relaxing	
/releas	release	released	releasing	
/relic	relic	relics	
/reliv	relive	reliving	
/remain	remain	remained	remaining	remains	
/remark	remarkable	remarkably	remarks	
/remedi	remedies	remedy	
/rememb	remember	remembered	remembering	remembers	
/remind	remind	reminded	reminder	reminders	reminding	reminds	
/reminisc	reminisce	reminiscent	reminiscing	
/remix	remix	remixed	
/remot	remote	remotely	
/remov	remove	removed	remover	removing	
/render	render	rendering	renders	
/rent	rent	rented	rents	
/reorgan	reorganize	reorganizing	
/repair	repair	repairs	
/repeat	repeat	repeated	repeating	repeats	
/replac	replace	replaced	replacement	replacing	
/replant	replanted	replanting	
/repli	replied	reply	
/report	report	reporter	reporting	reports	
/repres	represent	representative	represented	representing	represents	
/represent	representation	representations	
/repuls	repulsed	repulsive	
/reput	reputable	reputation	reputations	
/request	request	requested	requests	
/requir	require	required	requirement	requirements	requires	
/reschedul	reschedule	rescheduled	
/rescu	rescue	rescued	rescuing	
/research	research	researched	researchers	researching	
/resembl	resemblance	resemble	
/resent	resent	resentful	
/reserv	reservation	reservations	reserve	reserved	reserves	
/reservist	reservist	reservists	
/reset	reset	resets	
/resid	residence	residency	resident	residents	resides	
/resist	resist	resistance	resistant	
/resolv	resolve	resolved	
/resourc	resourceful	resources	
/respect	respect	respectable	respected	respectful	respectfully	respecting	
/respond	respond	responding	responds	
/respons	response	responsibilities	responsibility	responsible	
/rest	rest	rested	restful	resting	rests	
/restaur	restaurant	restaurants	
/restor	restoration	restorative	restore	restored	restoring	
/restrict	restricted	restrictive	
/result	result	resulting	results	
/resum	resume	resumes	
/retir	retire	retired	retirement	retiring	
/retreat	retreat	retreated	retreating	
/retriev	retrieve	retrieved	retrieving	
/return	return	returned	returning	returns	
/reunion	reunion	reunions	
/reunit	reunite	reunited	reuniting	
/rev	rev	revs	revving	
/reveal	reveal	revealed	reveals	
/revers	reversal	reverse	reversed	
/review	review	reviewed	
/revis	revise	revised	revision	
/reviv	revival	reviving	
/reward	reward	rewarded	rewarding	
/rewind	rewind	rewinding	
/rhineston	rhinestone	rhinestones	
/rhyme	rhyme	rhymes	rhyming	rhymings	
/rhythmic	rhythmic	rhythmically	
/ribbon	ribbon	ribbons	
/rich	rich	riches	
/riddl	riddle	riddles	
/ride	ride	rides	riding	
/ridicul	ridiculous	ridiculously	
/rift	rift	rifts	
/rig	rigged	rigging	
/right	right	rightful	rights	
/ring	ring	ringing	rings	
/rip	rip	ripped	ripping	rips	
/rise	rise	rises	rising	
/risk	risk	risked	risks	
/ritual	ritual	rituals	
/rival	rival	rivaled	rivals	
/river	river	rivers	
/rivet	rivet	riveted	riveter	
/road	road	roads	
/roar	roar	roaring	roars	
/roast	roast	roasting	
/rob	rob	robbed	
/robe	robe	robes	
/robot	robot	robotic	robotics	robots	
/roc	roc	rocs	
/rock	rock	rocked	rocking	rocks	
/rocket	rocket	rocketed	rockets	
/rodent	rodent	rodents	
/rodeo	rodeo	rodeos	
/rogu	rogue	rogues	
/role	role	roles	
/roll	roll	rolled	rolling	rolls	
/rooki	rookie	rookies	
/room	room	rooms	
/roomi	roomie	roomies	roomy	
/rooster	rooster	roosters	
/root	root	rooting	roots	
/rope	rope	roped	ropes	roping	
/rose	rose	roses	
/rosett	rosette	rosettes	
/rot	rot	rotting	
/rough	rough	roughing	
/round	round	rounded	rounding	roundness	rounds	
/rout	route	routes	
/routin	routine	routines	
/row	row	rowing	
/royal	royal	royally	royals	
/rsvp	rsvp	rsvps	
/rub	rub	rubbed	rubbing	rubs	
/rube	rube	rubes	
/rubi	rubies	ruby	
/rude	rude	rudely	
/ruffian	ruffian	ruffians	
/ruffl	ruffle	ruffled	
/ruin	ruin	ruined	ruining	ruins	
/rule	rule	ruled	rules	ruling	
/ruler	ruler	rulers	
/rumbl	rumble	rumbles	rumbling	
/rumor	rumor	rumors	
/rump	rump	rumps	
/run	run	running	runs	
/rush	rush	rushed	rushing	
/rustl	rustle	rustles	rustling	
/sabotag	sabotage	sabotaged	
/sack	sack	sacks	
/sad	sad	sadness	
/saddl	saddle	saddles	
/saddlebag	saddlebag	saddlebags	
/safe	safe	safely	
/sail	sail	sailed	sailing	
/sake	sake	sakes	
/sale	sale	sales	
/salesponi	salesponies	salespony	
/salt	salt	salted	
/salut	salutation	salutations	salute	
/same	same	sameness	
/sampl	sample	samples	
/sand	sand	sanded	
/sandwich	sandwich	sandwiches	
/sap	sap	sapped	
/sapphir	sapphire	sapphires	
/sarcast	sarcastic	sarcastically	
/sash	sash	sashes	
/satisfi	satisfied	satisfy	satisfying	
/save	save	saved	saves	saving	
/saw	saw	sawing	
/say	say	saying	says	
/scale	scale	scales	
/scar	scar	scars	
/scare	scare	scared	scares	scaring	
/scene	scene	scenes	
/scent	scent	scented	
/schedul	schedule	scheduled	schedules	scheduling	
/scheme	schemes	scheming	
/school	school	schooled	schools	
/schoolponi	schoolponies	schoolpony	
/scienc	science	scienced	
/scientif	scientific	scientifically	
/scoff	scoff	scoffs	
/scone	scone	scones	
/scoop	scoop	scooped	
/scoot	scoot	scooting	
/scooter	scooter	scootering	scooters	
/score	score	scored	scores	scoring	
/scorer	scorer	scorers	
/scout	scout	scouting	scouts	
/scrapbook	scrapbook	scrapbooking	
/scratch	scratch	scratched	scratches	scratching	
/scream	scream	screamed	screaming	screams	
/screech	screech	screeches	screeching	
/screw	screw	screwed	screws	
/scribbl	scribble	scribbles	scribbling	
/scroll	scroll	scrolls	
/scrub	scrub	scrubbing	
/scrubbi	scrubbied	scrubby	
/sculptur	sculpture	sculptures	
/sea	sea	seas	
/seagul	seagull	seagulls	
/seal	seal	sealed	seals	
/seam	seam	seams	
/seaponi	seaponies	seapony	
/search	search	searched	searching	
/season	season	seasoned	seasons	
/seat	seat	seated	seating	seats	
/second	second	seconds	
/secret	secret	secrete	secretive	secrets	
/section	section	sections	
/sector	sector	sectors	
/secur	secure	secured	security	
/sediment	sedimental	sediments	
/see	see	seeing	sees	
/seed	seed	seeds	
/seek	seek	seeking	seeks	
/seem	seem	seemed	seems	
/select	select	selected	selection	
/selfi	selfie	selfies	
/selfish	selfish	selfishness	
/sell	sell	selling	sells	
/seller	seller	sellers	
/send	send	sending	sends	
/sens	sense	sensed	senses	sensing	
/sensat	sensation	sensational	
/sensibl	sensibilities	sensible	
/sentiment	sentiment	sentimental	
/separ	separate	separated	separating	separation	
/sequenc	sequence	sequences	
/seren	serene	serenity	
/seri	seri	series	
/serpent	serpent	serpents	
/serv	serve	served	serves	serving	
/servic	service	services	
/session	session	sessions	
/set	set	sets	setting	settings	
/setback	setback	setbacks	
/settl	settle	settled	settles	settling	
/settler	settler	settlers	
/sever	several	severe	
/sew	sew	sewing	
/shade	shade	shades	
/shadow	shadow	shadows	
/shadowbolt	shadowbolt	shadowbolts	
/shake	shake	shakes	shaking	
/shallow	shallow	shallows	
/shame	shame	shamed	
/shape	shape	shaped	shapes	shaping	
/shard	shard	shards	
/share	share	shared	sharing	
/shatter	shatter	shattered	shattering	shatters	
/shave	shave	shaved	shaving	
/shear	shear	shears	
/shed	shed	shedding	
/sheet	sheet	sheets	
/shell	shell	shells	
/shelv	shelve	shelved	shelves	shelving	
/shi	shi	shy	
/shield	shield	shielded	shields	
/shift	shift	shifts	
/shimmer	shimmer	shimmered	shimmering	shimmers	
/shine	shine	shined	shines	shining	
/shing	shing	shings	
/ship	ship	ships	
/shirt	shirt	shirts	
/shiver	shiver	shivering	shivers	
/shock	shock	shocked	shocking	
/shoe	shoe	shoes	
/shoot	shoot	shooting	shoots	
/shop	shop	shopping	shops	
/shore	shore	shores	
/short	short	shorts	
/shortcut	shortcut	shortcuts	
/shot	shot	shots	
/shoulder	shoulder	shoulders	
/shout	shout	shouted	shouting	shouts	
/shove	shove	shoved	shoving	
/shovel	shovel	shoveling	shovels	
/show	show	showed	showing	shows	
/showcas	showcase	showcasing	
/shower	shower	showered	showers	
/shred	shred	shredded	shredding	
/shriek	shriek	shrieking	shrieks	
/shrimp	shrimp	shrimps	
/shrink	shrinking	shrinks	
/shrivel	shrivel	shriveling	
/shudder	shudder	shuddering	shudders	
/shuffl	shuffle	shuffling	
/shut	shut	shuts	shutting	
/shutter	shutter	shutters	
/si	si	sis	
/sibl	sibling	siblings	
/sick	sick	sickness	
/side	side	sided	sides	
/sidekick	sidekick	sidekicks	
/sidelin	sidelined	sidelines	
/sidewalk	sidewalk	sidewalks	
/sigh	sigh	sighing	sighs	
/sight	sight	sighted	sights	
/sign	sign	signed	signing	signs	
/signal	signal	signals	
/signific	significance	significant	
/silent	silent	silently	
/silic	silicate	silicates	
/silli	sillies	silliness	silly	
/simultan	simultaneous	simultaneously	
/sincer	sincere	sincerely	
/sing	sing	singing	sings	
/singer	singer	singers	
/singl	single	singled	
/sink	sink	sinking	sinks	
/sip	sip	sipping	sips	
/sir	sir	sirs	
/sire	sire	siree	
/siren	siren	sirens	
/sister	sister	sisters	
/sit	sit	sits	sitting	
/site	site	sites	
/situat	situation	situations	
/size	size	sized	sizes	
/sizzl	sizzle	sizzling	
/skate	skates	skating	
/skedaddl	skedaddle	skedaddling	
/sketch	sketch	sketched	sketching	
/ski	ski	skiing	skis	
/skid	skidding	skids	
/skill	skill	skills	
/skin	skin	skins	
/skip	skip	skipped	skipping	
/skirt	skirt	skirts	
/skosh	skosh	skoshes	
/skull	skull	skulls	
/skunk	skunk	skunks	
/sky	skies	sky	
/slam	slam	slammed	slamming	slams	
/slap	slap	slapped	slapping	slaps	
/slash	slash	slashes	slashing	
/slave	slaved	slaves	
/sleep	sleep	sleeping	sleeps	
/sleeper	sleeper	sleepers	
/sleepless	sleepless	sleeplessness	
/sleev	sleeve	sleeves	
/slice	slice	sliced	
/slide	slide	slides	sliding	
/slingshot	slingshot	slingshots	
/slingtail	slingtail	slingtails	
/slip	slip	slipped	slipping	
/slipper	slipper	slippers	
/slipperi	slipperier	slippery	
/slither	slither	slithering	
/slobber	slobber	slobbering	
/slow	slow	slowed	slowing	slows	
/slowpok	slowpoke	slowpokes	
/slumber	slumber	slumbers	
/slurp	slurp	slurping	slurps	
/smack	smack	smacking	smacks	
/smart	smart	smarts	
/smarti	smartie	smarty	
/smash	smash	smashed	smashes	smashing	
/smell	smell	smelled	smelling	smells	
/smile	smile	smiled	smiles	smiling	
/smoke	smoke	smoked	smokes	
/smooch	smooch	smooches	smooching	
/smoothi	smoothie	smoothies	
/snack	snack	snacking	snacks	
/snag	snag	snagged	
/snail	snail	snails	
/snake	snake	snakes	snaking	
/snap	snap	snapped	snapping	snaps	
/snarl	snarl	snarling	snarls	
/sneak	sneak	sneaking	
/sneez	sneeze	sneezes	sneezing	
/snicker	snicker	snickering	snickers	
/sniff	sniff	sniffs	
/sniffl	sniffles	sniffling	
/snip	snip	snipping	snips	
/snitch	snitch	snitches	
/snob	snob	snobs	
/snoop	snoop	snooped	snooping	
/snooti	snootiness	snooty	
/snooz	snooze	snoozing	
/snore	snore	snored	snores	snoring	
/snort	snort	snorted	snorting	snorts	
/snout	snout	snouts	
/snow	snow	snowing	
/snowbal	snowball	snowballs	
/snowflak	snowflake	snowflakes	
/soak	soak	soaked	soaking	soaks	
/soar	soar	soared	soaring	soars	
/sob	sob	sobbing	sobs	
/social	social	socialize	socializing	socials	
/sock	sock	socks	
/sofa	sofa	sofas	
/soldier	soldier	soldiers	
/sole	sole	solely	
/solid	solid	solids	
/solo	solo	soloing	
/solut	solutely	solution	
/solv	solve	solved	solves	solving	
/someponi	someponies	somepony	
/someth	someth	something	somethings	
/sometim	sometime	sometimes	
/song	song	songs	
/sooth	soothe	soothing	
/sophist	sophisticated	sophistication	
/sorcer	sorcerer	sorcerers	
/sort	sort	sorted	sorting	sorts	
/soufflã©	soufflã©	soufflã©s	
/soul	soul	souls	
/sound	sound	sounded	sounding	sounds	
/sourc	source	sourced	sources	
/souvenir	souvenir	souvenirs	
/space	space	spaced	spaces	
/spar	spar	spars	
/spare	spare	spares	
/spark	spark	sparking	sparks	
/sparkl	sparkle	sparkled	sparkles	sparkling	
/speak	speak	speaking	speaks	
/speaker	speaker	speakers	
/special	special	specializes	specially	specials	
/specialti	specialties	specialty	
/specif	specific	specifically	
/speck	speck	specks	
/spectacl	spectacle	spectacles	
/spectat	spectator	spectators	
/speech	speech	speeches	
/speed	speed	speeding	
/speedster	speedster	speedsters	
/spell	spell	spelled	spelling	spells	
/spend	spend	spending	spends	
/spi	spi	spies	spy	spying	
/spice	spice	spiced	spices	
/spider	spider	spiders	
/spike	spike	spiked	spikes	
/spill	spill	spilled	spills	
/spin	spin	spinning	spins	
/spine	spine	spines	
/spiral	spiral	spiraling	
/spire	spire	spires	
/spirit	spirit	spirits	
/spit	spit	spits	spitting	
/splash	splash	splashed	splashes	splashing	
/splat	splat	splats	splatting	
/splatter	splatter	splattered	splattering	
/splendor	splendor	splendors	
/splinter	splintering	splinters	
/split	split	splits	splitting	
/splut	splut	spluts	
/splutter	spluttering	splutters	
/spoil	spoil	spoiled	spoils	
/spoiler	spoiler	spoilers	
/spoon	spoon	spoons	
/sport	sport	sporting	sports	
/sporti	sportiness	sporty	
/sportsponi	sportsponies	sportspony	
/spot	spot	spots	spotted	
/spotlight	spotlight	spotlights	
/sprain	sprain	sprained	
/spray	spray	spraying	sprays	
/sprayer	sprayer	sprayers	
/spread	spread	spreading	spreads	
/spring	spring	springing	springs	
/sprinkl	sprinkle	sprinkles	sprinkling	
/sprinkler	sprinkler	sprinklers	
/sprint	sprint	sprinted	
/sprout	sprout	sprouted	sprouts	
/spruce	spruce	sprucing	
/spur	spur	spurs	
/sputter	sputtering	sputters	
/squad	squad	squads	
/squar	square	squared	squarely	squares	
/squash	squash	squashed	
/squawk	squawk	squawking	squawks	
/squeak	squeak	squeaking	squeaks	
/squeal	squeal	squealing	squeals	
/squee	squee	squees	
/squeez	squeeze	squeezed	
/squelch	squelch	squelching	
/squirrel	squirrel	squirrels	
/squirt	squirt	squirting	squirts	
/squish	squish	squished	squishing	
/stabl	stable	stables	
/stack	stack	stacking	stacks	
/stage	stage	stages	staging	
/stain	stain	stained	stains	
/stair	stair	stairs	
/stake	stake	stakes	
/stalk	stalk	stalks	
/stall	stall	stalling	stalls	
/stallion	stallion	stallions	
/stammer	stammering	stammers	
/stamp	stamp	stamped	stamping	stamps	
/stamped	stampede	stampeded	stampeding	
/stand	stand	standing	stands	
/standard	standard	standards	
/star	star	starring	stars	
/stare	stare	stared	stares	staring	
/starswirl	starswirl	starswirled	
/start	start	started	starting	starts	
/startl	startle	startled	startling	
/starv	starve	starved	starving	
/stash	stash	stashed	stashes	
/stat	stat	stats	
/state	state	states	
/station	station	stations	
/statist	statistic	statistical	
/statu	statue	statues	status	
/stay	stay	stayed	staying	stays	
/steal	steal	stealing	steals	
/steam	steam	steaming	
/steer	steer	steered	steering	
/stem	stem	stems	
/step	step	stepped	stepping	steps	
/stick	stick	sticking	sticks	
/sticker	sticker	stickers	
/stifl	stifled	stifles	stifling	
/sting	sting	stinging	stings	
/stinki	stinkie	stinky	
/stir	stir	stirred	stirring	stirs	
/stitch	stitch	stitched	stitches	stitching	
/stock	stock	stocked	stocking	
/stomach	stomach	stomachs	
/stomp	stomp	stomped	stomping	stomps	
/stone	stone	stones	
/stoop	stoop	stooping	stoops	
/stop	stop	stopped	stopping	stops	
/stopper	stopper	stoppers	
/store	store	stored	stores	
/stori	stories	story	
/storm	storm	stormed	storms	
/straighten	straighten	straightening	
/strain	strain	strained	straining	strains	
/strand	strand	stranded	
/strang	strange	strangely	
/stranger	stranger	strangers	
/strangl	strangled	strangles	
/strap	strap	strapped	strapping	
/straw	straw	straws	
/strawberri	strawberries	strawberry	
/streamer	streamer	streamers	
/street	street	streets	
/strength	strength	strengths	
/stress	stress	stressed	stressful	stressing	
/stretch	stretch	stretches	stretching	
/stride	stride	striding	
/strike	strike	strikes	striking	
/string	string	stringing	strings	
/strip	strip	stripped	
/stripe	stripe	striped	stripes	
/strive	strive	striving	
/stroke	stroke	strokes	
/structur	structural	structure	structures	
/struggl	struggle	struggled	struggles	struggling	
/strum	strum	strumming	strums	
/strut	strut	strutted	
/student	student	students	
/studi	studied	studies	study	studying	
/stuf	stuf	stuffed	stuffing	
/stumbl	stumble	stumbled	
/stunt	stunt	stunts	
/stupend	stupendous	stupendously	
/stutter	stuttering	stutters	
/style	style	styled	styles	styling	stylings	
/stylist	stylist	stylistic	stylists	
/sub	sub	subs	
/subject	subject	subjecting	subjects	
/sublim	sublimation	sublime	
/submit	submit	submitted	
/substanc	substance	substances	
/substitut	substitute	substituting	
/succeed	succeed	succeeded	succeeding	
/success	success	successes	successful	successfully	
/suck	suck	sucked	sucking	sucks	
/suffer	suffer	suffered	suffering	
/sugarcub	sugarcube	sugarcubes	
/sugarplum	sugarplum	sugarplums	
/suggest	suggest	suggested	suggesting	suggestion	suggestions	
/suit	suit	suite	suited	suites	suits	
/suitcas	suitcase	suitcases	
/sum	sum	sums	
/summon	summon	summoned	summoning	summons	
/sunda	sundae	sundaes	
/sunflow	sunflower	sunflowers	
/sunset	sunset	sunsets	
/superhero	superhero	superheroes	
/superl	superlative	superlatives	
/supernatur	supernatural	supernaturals	
/superpow	superpower	superpowers	
/superstar	superstar	superstars	
/supervis	supervise	supervising	supervision	
/suppli	supplies	supply	
/support	support	supported	supporter	supporting	supportive	
/suppos	suppose	supposed	
/sure	sure	surely	
/surf	surf	surfing	
/surg	surge	surges	surging	
/surpris	surprise	surprised	surprises	surprising	
/surrend	surrender	surrendering	
/surround	surround	surrounded	surrounding	surrounds	
/survey	survey	surveying	surveys	
/surviv	survive	survived	survives	
/suspect	suspect	suspected	suspects	
/suspens	suspense	suspenseful	
/suspici	suspicious	suspiciously	
/suspicion	suspicion	suspicions	
/sustain	sustain	sustaining	
/swallow	swallow	swallowed	swallowing	swallows	
/swamp	swamp	swamped	
/swan	swan	swans	
/swap	swap	swapped	
/swarm	swarm	swarmed	swarming	
/swear	swear	sweared	
/sweat	sweat	sweating	sweats	
/sweep	sweep	sweeping	
/sweet	sweet	sweetness	sweets	
/sweeti	sweetie	sweeties	
/swell	swell	swelling	
/swim	swim	swimming	
/swing	swing	swinging	swings	
/swirl	swirl	swirled	swirling	
/switch	switch	switched	switching	
/swoon	swoon	swooning	swoons	
/swoop	swoop	swooped	
/sword	sword	swords	
/symbol	symbol	symbolism	symbolized	symbols	
/tab	tab	tabs	
/tabl	table	tables	
/tablecloth	tablecloth	tablecloths	
/tablespoon	tablespoon	tablespoons	
/tack	tack	tacking	
/tackl	tackle	tackled	
/taco	taco	tacos	
/tact	tact	tactfully	
/tactic	tactic	tactics	
/taffi	taffies	taffy	
/tail	tail	tailed	tails	
/tailor	tailor	tailored	tailoring	
/take	take	takes	taking	
/taker	taker	takers	
/tale	tale	tales	
/talent	talent	talented	talents	
/talisman	talisman	talismans	
/talk	talk	talkative	talked	talking	talks	
/talker	talker	talkers	
/tambourin	tambourine	tambourines	
/tame	tame	tamed	taming	
/tangl	tangle	tangled	
/tank	tank	tanks	
/tap	tap	tapped	tapping	taps	
/tapestri	tapestries	tapestry	
/tart	tart	tarts	
/task	task	tasked	tasks	
/tast	taste	tasted	tastes	tasting	
/tater	tater	taters	
/tatzlwurm	tatzlwurm	tatzlwurms	
/tax	tax	taxes	taxing	
/tea	tea	teas	
/teach	teach	teaches	teaching	
/teacher	teacher	teachers	
/team	team	teamed	teams	
/teammat	teammate	teammates	
/teapot	teapot	teapots	
/tear	tear	tearfully	tearing	tears	
/teas	tease	teased	teasing	
/teaspoon	teaspoon	teaspoons	
/techniqu	technique	techniques	
/teddi	teddie	teddy	
/teleport	teleport	teleportation	teleported	teleporting	teleports	
/telescop	telescope	telescopes	
/tell	tell	telling	tells	
/temper	temper	tempers	
/templ	temple	temples	
/tempt	tempt	tempting	tempts	
/tend	tend	tended	tending	tends	
/tender	tender	tenderness	
/tent	tent	tentatively	tents	
/term	term	terms	
/terribl	terrible	terribly	
/terrif	terrific	terrifically	
/terrifi	terrified	terrify	terrifying	
/terror	terror	terrorize	terrorized	
/test	test	tested	testing	tests	
/text	text	texted	texts	
/textur	texture	textures	
/thang	thang	thangs	
/thank	thank	thanked	thankful	thankfully	thanking	thanks	
/theater	theater	theaters	
/their	their	theirs	
/theme	theme	themed	
/theori	theories	theory	
/thi	this	thy	
/thiev	thieves	thieving	
/thing	thing	things	
/thingi	thingies	thingy	
/think	think	thinking	thinks	
/third	third	thirds	
/thorn	thorn	thorns	
/thought	thought	thoughtful	thoughts	
/thoughtless	thoughtless	thoughtlessness	
/thousand	thousand	thousands	
/thread	thread	threads	
/threat	threat	threats	
/threaten	threaten	threatened	threatening	
/three	three	threes	
/thrill	thrill	thrilled	thrilling	
/thrive	thrive	thriving	
/throat	throat	throats	
/through	through	throughs	
/throw	throw	throwing	throws	
/throwback	throwback	throwbacks	
/thrust	thrust	thrusts	
/thud	thud	thudding	thuds	
/thump	thump	thumping	thumps	
/thunder	thunder	thunderation	thundering	thunderous	
/thunk	thunk	thunking	thunks	
/thwack	thwack	thwacking	
/thwart	thwart	thwarts	
/ti	ti	tis	
/tick	tick	ticked	ticking	ticks	
/ticket	ticket	tickets	
/tickl	tickle	tickled	tickles	
/tide	tide	tides	tidings	
/tie	tie	tied	ties	tying	
/tiger	tiger	tigers	
/tight	tight	tights	
/tighten	tighten	tightening	
/time	time	times	timing	
/tin	tin	tins	
/ting	ting	tinge	
/tingl	tingle	tingling	
/tip	tip	tipped	tips	
/tipto	tiptoe	tiptoeing	
/tire	tire	tired	tires	
/titl	title	titles	
/titter	tittering	titters	
/toast	toast	toasted	
/toe	toe	toes	
/toenail	toenail	toenails	
/togeth	together	togetherness	
/toil	toile	toiled	toilings	toils	
/tomat	tomater	tomatered	tomaters	
/tomato	tomato	tomatoes	
/ton	ton	tons	
/tone	tone	toned	tones	
/tongu	tongue	tongues	
/tonic	tonic	tonics	
/toodl	toodle	toodles	
/tool	tool	tooled	tools	
/toot	toot	toots	
/toothbrush	toothbrush	toothbrushes	
/top	top	topped	toppings	tops	
/toppl	toppled	toppling	
/tor	tor	tors	
/torch	torch	torches	
/tortois	tortoise	tortoises	
/toss	toss	tossed	tossing	
/total	total	totally	
/toucan	toucan	toucans	
/touch	touch	touched	touches	touching	
/tour	tour	toured	touring	tours	
/tourist	tourist	tourists	
/toward	toward	towards	
/towel	towel	towels	
/tower	tower	towers	
/town	town	towns	
/townsponi	townsponies	townspony	
/toy	toy	toys	
/trace	trace	traced	
/track	track	tracking	tracks	
/trade	trade	traded	trading	
/trader	trader	traders	
/tradit	tradition	traditional	traditionally	traditions	
/trail	trail	trailing	trails	
/train	train	trained	training	trains	
/trait	trait	traits	
/tranc	trance	trances	
/transfer	transfer	transferred	
/transform	transform	transformation	transformed	transforming	transforms	
/translat	translate	translates	translating	translation	translator	
/transport	transport	transportation	transported	transporting	
/trap	trap	trapped	trapping	traps	
/trash	trash	trashed	trashes	trashing	
/traumat	traumatic	traumatized	
/travel	travel	traveled	traveler	travelers	traveling	travelled	travels	
/tray	tray	trays	
/treasur	treasure	treasures	
/treat	treat	treated	treating	treats	
/treatment	treatment	treatments	
/tree	tree	trees	
/trek	trek	trekked	trekking	
/trembl	trembles	trembling	
/trend	trend	trending	trends	
/trendsett	trendsetter	trendsetters	
/trespass	trespassers	trespassing	
/tri	tri	tried	tries	try	trying	
/trial	trial	trials	
/tribe	tribe	tribes	
/trick	trick	tricked	tricking	tricks	
/trigger	trigger	triggered	triggers	
/trim	trim	trimmed	
/trimmer	trimmer	trimmers	
/trip	trip	tripped	tripping	trips	
/triplic	triplicate	triplicates	
/trophi	trophies	trophy	
/trot	trot	trots	trotted	trotting	
/troubl	trouble	troubled	troubles	
/troup	troupe	troupes	
/trumpet	trumpet	trumpeting	trumpets	
/trust	trust	trusted	trusting	trusts	
/tryout	tryout	tryouts	
/tub	tub	tubs	
/tuck	tuck	tucked	
/tuesday	tuesday	tuesdays	
/tuft	tuft	tufted	tufts	
/tumbl	tumble	tumbling	
/tumblewe	tumbleweed	tumbleweeds	
/tummi	tummies	tummy	
/tune	tune	tuned	tunes	tuning	
/tunnel	tunnel	tunnels	
/turn	turn	turned	turning	turns	
/turnip	turnip	turnips	
/turnov	turnover	turnovers	
/turtl	turtle	turtles	
/tussl	tussle	tussling	
/tute	tutely	tutes	
/tutor	tutor	tutors	
/tweak	tweak	tweaked	tweaks	
/tweet	tweet	tweeting	tweets	
/twilight	twilight	twilights	
/twin	twin	twins	
/twinkl	twinkle	twinkling	
/twirl	twirl	twirling	
/twist	twist	twisted	twists	
/twitch	twitch	twitches	twitching	
/twitter	twittering	twitters	
/type	type	types	
/typewrit	typewriter	typewriters	
/ultim	ultimate	ultimately	
/umbrella	umbrella	umbrellas	
/un	un	uns	
/unappreci	unappreciated	unappreciative	
/unbear	unbearable	unbearably	
/unbeliev	unbelievable	unbelievably	
/uncheck	uncheck	unchecked	
/uncl	uncle	uncles	
/uncomfort	uncomfortable	uncomfortably	
/uncontrol	uncontrollable	uncontrollably	
/unconvinc	unconvinced	unconvincing	
/uncov	uncover	uncovering	
/uncrumpl	uncrumpled	uncrumples	
/undeni	undeniable	undeniably	
/underestim	underestimate	underestimated	
/undergo	undergoes	undergoing	
/understand	understand	understandable	understanding	understands	
/undo	undo	undoing	
/unenthusiast	unenthusiastic	unenthusiastically	
/unfortun	unfortunate	unfortunately	
/unfurl	unfurl	unfurled	unfurling	
/unhappi	unhappiness	unhappy	
/unicorn	unicorn	unicorns	
/unidentifi	unidentifiable	unidentified	
/unifi	unified	unify	
/uniform	uniform	uniforms	
/unit	unit	unite	united	unites	
/univers	universal	universe	university	
/unlatch	unlatches	unlatching	
/unleash	unleash	unleashed	unleashes	
/unlik	unlike	unlikely	
/unlock	unlock	unlocked	unlocking	unlocks	
/unpack	unpack	unpacking	
/unrealist	unrealistic	unrealistically	
/unrol	unrolling	unrolls	
/unusu	unusual	unusually	
/unwrap	unwrap	unwrapped	
/up	up	ups	
/updat	update	updates	
/upset	upset	upsets	upsetting	
/urg	urge	urged	
/use	use	used	useful	uses	using	
/user	user	users	
/usual	usual	usually	
/utter	utter	uttering	
/vacat	vacation	vacationing	
/vacuum	vacuum	vacuuming	
/vagu	vague	vaguely	
/valid	valid	validate	
/valu	value	valued	values	
/valv	valve	valves	
/vanish	vanish	vanished	
/vanquish	vanquish	vanquished	
/vant	vant	vants	
/vapor	vapor	vaporization	
/vari	varied	varying	
/variabl	variable	variables	
/varieti	varieties	variety	
/varmint	varmint	varmints	
/vast	vast	vastness	
/veget	vegetable	vegetables	
/veggi	veggie	veggies	
/veil	veil	veils	
/veloc	velocities	velocity	
/vent	vent	vents	
/ventur	venture	ventured	
/version	version	versions	
/vest	vest	vested	vests	
/vibe	vibe	vibes	
/vibrat	vibrates	vibrating	vibrations	
/victim	victim	victims	
/victori	victorious	victory	
/video	video	videos	
/view	view	viewed	viewings	
/villag	village	villager	villagers	villages	
/villain	villain	villains	
/vine	vine	vines	
/vintag	vintage	vintaged	
/violet	violet	violets	
/visit	visit	visited	visiting	visits	
/visitor	visitor	visitors	
/visual	visual	visualization	visualize	visually	visuals	
/vocal	vocal	vocalizes	vocalizing	vocals	
/voic	voice	voices	voicing	
/volleybal	volleyball	volleyballs	
/volum	volume	volumes	
/volunt	volunteer	volunteered	volunteers	
/vote	vote	voted	votes	voting	
/vow	vow	vowed	vows	
/vroom	vroom	vrooming	
/wa	wa	was	
/waddl	waddle	waddles	
/wagon	wagon	wagons	
/wail	wail	wailing	wails	
/wait	wait	waited	waiting	waits	
/waiter	waiter	waiters	
/wake	wake	wakes	waking	
/walk	walk	walked	walking	walks	
/wall	wall	walls	
/wander	wander	wandered	wandering	
/want	want	wanted	wanting	wants	
/warbl	warbles	warbling	
/warm	warm	warmed	warming	warms	
/warn	warn	warned	warning	
/warrant	warranted	warrants	
/warrior	warrior	warriors	
/wash	wash	washed	washing	
/washout	washout	washouts	
/wast	waste	wasted	wastes	wasting	
/watch	watch	watched	watches	watching	
/water	water	watering	waters	
/waterfal	waterfall	waterfalls	
/wave	wave	waved	waves	waving	
/wax	wax	waxed	
/way	way	ways	
/weak	weak	weakness	weaknesses	
/weapon	weapon	weapons	
/wear	wear	wearing	wears	
/weav	weave	weaves	weaving	
/web	web	webs	
/wed	wedded	wedding	weddings	
/week	week	weeks	
/weekend	weekend	weekends	
/weep	weep	weeping	
/weigh	weigh	weighs	
/weird	weird	weirded	
/welcom	welcome	welcomed	welcoming	
/well	well	welling	wells	
/whack	whack	whacking	whacks	
/whale	whale	whales	
/whatev	whatever	whatevs	
/wheel	wheel	wheeling	wheels	
/wheez	wheezes	wheezing	
/whi	whi	why	
/whicker	whickering	whickers	
/whim	whim	whims	
/whimper	whimper	whimpering	whimpers	
/whine	whine	whines	whining	
/whinni	whinnies	whinny	whinnying	
/whip	whip	whipped	whipping	whips	
/whir	whirring	whirs	
/whirl	whirl	whirling	whirls	
/whirr	whirr	whirrs	
/whisk	whisk	whisked	
/whisper	whisper	whispered	whispering	whispers	
/whistl	whistle	whistles	whistling	
/white	white	whites	
/whoa	whoa	whoas	
/whoop	whoop	whooped	whooping	whoops	
/whoopsi	whoopsie	whoopsies	
/whoosh	whoosh	whooshes	whooshing	
/wibbl	wibbles	wibbling	
/wick	wick	wicked	
/wield	wield	wielded	
/wilder	wilder	wilderness	
/will	will	willful	willing	wills	
/willi	willies	willy	
/wimp	wimp	wimps	
/win	win	winning	winnings	wins	
/winc	winces	wincing	
/wind	wind	winded	winding	winds	
/windigo	windigo	windigos	
/window	window	windows	
/windsurf	windsurf	windsurfing	
/wing	wing	winged	wings	
/wingponi	wingponies	wingpony	
/wink	wink	winks	
/winner	winner	winners	
/winterzilla	winterzilla	winterzillas	
/wipe	wipe	wiped	wipes	wiping	
/wire	wire	wires	
/wise	wise	wisely	
/wish	wish	wished	wishes	wishing	
/wisp	wisp	wisps	
/wit	wit	witness	witnessed	wits	
/witch	witch	witching	
/wizard	wizard	wizarding	
/wobbl	wobble	wobbles	wobbling	wobbly	
/woe	woe	woes	
/wonder	wonder	wondered	wonderful	wonderfully	wondering	wonders	
/wonderbolt	wonderbolt	wonderbolts	
/wondercolt	wondercolt	wondercolts	
/wood	wood	woods	
/wootsi	wootsie	wootsy	
/word	word	words	
/work	work	worked	working	works	
/worker	worker	workers	
/workhors	workhorse	workhorses	
/workout	workout	workouts	
/world	world	worlds	
/worm	worm	worms	
/worri	worried	worries	worry	worrying	
/wound	wound	wounded	wounds	
/wow	wow	wowed	wowing	
/wrangl	wrangle	wrangled	wrangling	
/wrap	wrap	wrapped	wrapping	wraps	
/wreak	wreak	wreaking	
/wreck	wreck	wrecked	wrecks	
/wrench	wrench	wrenching	
/wrestl	wrestle	wrestling	
/wriggl	wriggle	wriggling	
/wrinkl	wrinkle	wrinkles	
/write	write	writes	writing	writings	
/ya	ya	yas	
/yak	yak	yaks	
/yank	yank	yanking	
/yard	yard	yards	
/yarn	yarn	yarns	
/yawn	yawn	yawning	yawns	
/ye	ye	yes	
/year	year	years	
/yearn	yearning	yearns	
/yeee	yeee	yeees	
/yeeee	yeeee	yeeees	
/yell	yell	yelled	yelling	yells	
/yelp	yelp	yelping	yelps	
/yodel	yodel	yodeling	
/your	your	yours	
/youth	youth	youthful	
/yovidaphon	yovidaphone	yovidaphoner	
/yowl	yowl	yowling	yowls	
/yuck	yuck	yucks	
/zap	zap	zapped	zapping	zaps	
/zebra	zebra	zebras	
/zero	zero	zeroes	
/zig	zig	zigged	
/zip	zip	zipped	zipping	zips	
/zipper	zipper	zippers	
/zombi	zombie	zombies	
/zoom	zoom	zoomed	zooming	zooms	
/ã©clair	ã©clair	ã©clairs	
